xc,yc,w,h,theta,depth,width_mid_x,width_mid_y,height_mid_x,height_mid_y,x1_x,x1_y,x2_x,x2_y,x3_x,x3_y,x4_x,x4_y,sample_time
500,384,225,189,0,0.3070000112056732,500.5,479,388,384.5,388,290,388,479,613,290,613,479,3.043283700942993
501,385,225,188,0,0.3060000240802765,501.5,479,389,385.0,389,291,389,479,614,291,614,479,0.12167167663574219
500,384,225,189,0,0.3070000112056732,500.5,479,388,384.5,388,290,388,479,613,290,613,479,0.07462716102600098
500,384,225,189,0,0.3070000112056732,500.5,479,388,384.5,388,290,388,479,613,290,613,479,0.0639960765838623
500,384,225,189,0,0.3070000112056732,500.5,479,388,384.5,388,290,388,479,613,290,613,479,0.06663775444030762
501,384,226,189,0,0.30800002813339233,501.0,479,388,384.5,388,290,388,479,614,290,614,479,0.0670781135559082
501,384,225,189,0,0.3070000112056732,501.5,479,389,384.5,389,290,389,479,614,290,614,479,0.06619477272033691
501,384,225,189,0,0.3070000112056732,501.5,479,389,384.5,389,290,389,479,614,290,614,479,0.06652235984802246
500,384,225,189,0,0.3070000112056732,500.5,479,388,384.5,388,290,388,479,613,290,613,479,0.06591224670410156
501,384,226,189,0,0.3070000112056732,501.0,479,388,384.5,388,290,388,479,614,290,614,479,0.06775379180908203
501,384,226,189,0,0.3070000112056732,501.0,479,388,384.5,388,290,388,479,614,290,614,479,0.06525802612304688
501,384,226,189,0,0.3070000112056732,501.0,479,388,384.5,388,290,388,479,614,290,614,479,0.06681084632873535
500,384,225,189,0,0.3070000112056732,500.5,479,388,384.5,388,290,388,479,613,290,613,479,0.06696510314941406
500,384,225,189,0,0.3060000240802765,500.5,479,388,384.5,388,290,388,479,613,290,613,479,0.06650447845458984
500,384,225,189,0,0.30800002813339233,500.5,479,388,384.5,388,290,388,479,613,290,613,479,0.06672072410583496
501,384,226,189,0,0.3060000240802765,501.0,479,388,384.5,388,290,388,479,614,290,614,479,0.06621861457824707
501,384,226,189,0,0.3070000112056732,501.0,479,388,384.5,388,290,388,479,614,290,614,479,0.06914520263671875
501,384,226,189,0,0.3070000112056732,501.0,479,388,384.5,388,290,388,479,614,290,614,479,0.06429028511047363
501,384,225,189,0,0.3070000112056732,501.5,479,389,384.5,389,290,389,479,614,290,614,479,0.06608939170837402
501,384,226,189,0,0.3070000112056732,501.0,479,388,384.5,388,290,388,479,614,290,614,479,0.06744003295898438
500,384,225,189,0,0.3070000112056732,500.5,479,388,384.5,388,290,388,479,613,290,613,479,0.06628251075744629
500,384,225,189,0,0.3070000112056732,500.5,479,388,384.5,388,290,388,479,613,290,613,479,0.06656742095947266
501,384,226,189,0,0.3070000112056732,501.0,479,388,384.5,388,290,388,479,614,290,614,479,0.0662989616394043
500,384,225,189,0,0.3070000112056732,500.5,479,388,384.5,388,290,388,479,613,290,613,479,0.06688213348388672
501,384,226,189,0,0.3070000112056732,501.0,479,388,384.5,388,290,388,479,614,290,614,479,0.0683143138885498
501,384,225,189,0,0.30800002813339233,501.5,479,389,384.5,389,290,389,479,614,290,614,479,0.06404328346252441
501,384,226,189,0,0.3070000112056732,501.0,479,388,384.5,388,290,388,479,614,290,614,479,0.06760525703430176
501,384,226,189,0,0.3060000240802765,501.0,479,388,384.5,388,290,388,479,614,290,614,479,0.06619954109191895
500,384,225,189,0,0.3060000240802765,500.5,479,388,384.5,388,290,388,479,613,290,613,479,0.06715059280395508
499,384,224,189,0,0.3060000240802765,499.0,479,387,384.5,387,290,387,479,611,290,611,479,0.06674909591674805
496,384,224,190,0,0.3070000112056732,496.0,479,384,384.0,384,289,384,479,608,289,608,479,0.06636929512023926
492,383,222,191,0,0.3070000112056732,492.0,479,381,383.5,381,288,381,479,603,288,603,479,0.0665888786315918
488,382,220,193,0,0.3070000112056732,488.0,479,378,382.5,378,286,378,479,598,286,598,479,0.0660700798034668
484,381,220,195,0,0.3070000112056732,484.0,479,374,381.5,374,284,374,479,594,284,594,479,0.06703543663024902
478,380,217,197,0,0.3070000112056732,478.5,479,370,380.5,370,282,370,479,587,282,587,479,0.06637883186340332
472,379,216,200,0,0.3070000112056732,472.0,479,364,379.0,364,279,364,479,580,279,580,479,0.06592273712158203
465,378,214,202,0,0.3070000112056732,465.0,479,358,378.0,358,277,358,479,572,277,572,479,0.06720757484436035
457,376,212,206,0,0.3070000112056732,457.0,479,351,376.0,351,273,351,479,563,273,563,479,0.06655573844909668
448,374,209,209,0,0.3070000112056732,448.5,479,344,374.5,344,270,344,479,553,270,553,479,0.06639647483825684
439,372,207,214,0,0.3060000240802765,439.5,479,336,372.0,336,265,336,479,543,265,543,479,0.0671989917755127
429,370,204,218,0,0.3060000240802765,429.0,479,327,370.0,327,261,327,479,531,261,531,479,0.06628727912902832
417,366,199,220,0,0.30800002813339233,417.5,476,318,366.0,318,256,318,476,517,256,517,476,0.06643557548522949
407,361,196,220,0,0.30800002813339233,407.0,471,309,361.0,309,251,309,471,505,251,505,471,0.06665539741516113
389,353,192,220,0,0.30900001525878906,389.0,463,293,353.0,293,243,293,463,485,243,485,463,0.09989166259765625
375,347,189,220,0,0.3100000023841858,375.5,457,281,347.0,281,237,281,457,470,237,470,457,0.06709122657775879
361,338,187,217,0,0.31200000643730164,361.5,447,268,338.5,268,230,268,447,455,230,455,447,0.06639528274536133
346,331,185,217,0,0.31300002336502075,346.5,440,254,331.5,254,223,254,440,439,223,439,440,0.06684160232543945
331,323,184,215,0,0.0,331.0,431,239,323.5,239,216,239,431,423,216,423,431,0.06668758392333984
315,315,185,216,0,0.0,315.5,423,223,315.0,223,207,223,423,408,207,408,423,0.0672750473022461
301,308,182,215,0,0.2330000102519989,301.0,416,210,308.5,210,201,210,416,392,201,392,416,0.0654752254486084
287,300,182,214,0,0.0,287.0,407,196,300.0,196,193,196,407,378,193,378,407,0.06666851043701172
273,293,181,214,0,0.0,273.5,400,183,293.0,183,186,183,400,364,186,364,400,0.0666649341583252
262,286,182,213,0,0.0,262.0,393,171,286.5,171,180,171,393,353,180,353,393,0.06661868095397949
251,280,181,213,0,0.0,251.5,387,161,280.5,161,174,161,387,342,174,342,387,0.06657242774963379
240,274,179,212,0,0.27400001883506775,240.5,380,151,274.0,151,168,151,380,330,168,330,380,0.06676840782165527
232,268,180,211,0,0.0,232.0,374,142,268.5,142,163,142,374,322,163,322,374,0.06717300415039062
223,264,179,212,0,0.0,223.5,370,134,264.0,134,158,134,370,313,158,313,370,0.06621479988098145
215,259,179,213,0,0.0,215.5,366,126,259.5,126,153,126,366,305,153,305,366,0.0662529468536377
208,256,178,215,0,0.0,208.0,364,119,256.5,119,149,119,364,297,149,297,364,0.0674283504486084
202,257,178,224,0,0.0,202.0,369,113,257.0,113,145,113,369,291,145,291,369,0.06568503379821777
196,249,179,216,0,0.0,196.5,357,107,249.0,107,141,107,357,286,141,286,357,0.0671079158782959
191,244,178,215,0,0.0,191.0,352,102,244.5,102,137,102,352,280,137,280,352,0.06634211540222168
187,240,178,211,0,0.0,187.0,346,98,240.5,98,135,98,346,276,135,276,346,0.06608200073242188
183,237,179,211,0,0.2880000174045563,183.5,343,94,237.5,94,132,94,343,273,132,273,343,0.06759119033813477
180,236,178,211,0,0.28600001335144043,180.0,342,91,236.5,91,131,91,342,269,131,269,342,0.06757187843322754
178,235,178,212,0,0.2900000214576721,178.0,341,89,235.0,89,129,89,341,267,129,267,341,0.06533408164978027
176,234,178,212,0,0.2900000214576721,176.0,340,87,234.0,87,128,87,340,265,128,265,340,0.06612586975097656
175,233,178,212,0,0.2900000214576721,175.0,339,86,233.0,86,127,86,339,264,127,264,339,0.06675863265991211
175,232,178,213,0,0.28700000047683716,175.0,339,86,232.5,86,126,86,339,264,126,264,339,0.06649398803710938
175,232,178,213,0,0.29100000858306885,175.0,339,86,232.5,86,126,86,339,264,126,264,339,0.06658768653869629
175,233,178,213,0,0.289000004529953,175.0,340,86,233.5,86,127,86,340,264,127,264,340,0.06738901138305664
175,234,178,212,0,0.289000004529953,175.0,340,86,234.0,86,128,86,340,264,128,264,340,0.06562948226928711
175,235,178,212,0,0.29100000858306885,175.0,341,86,235.0,86,129,86,341,264,129,264,341,0.0671696662902832
176,237,177,212,0,0.29200002551078796,176.5,343,88,237.0,88,131,88,343,265,131,265,343,0.06611037254333496
177,238,176,210,0,0.2930000126361847,177.0,343,89,238.0,89,133,89,343,265,133,265,343,0.06733560562133789
178,240,175,208,0,0.0,178.5,344,91,240.0,91,136,91,344,266,136,266,344,0.06650209426879883
179,242,175,208,0,0.0,179.5,346,92,242.0,92,138,92,346,267,138,267,346,0.06626224517822266
181,245,174,207,0,0.30000001192092896,181.0,349,94,245.5,94,142,94,349,268,142,268,349,0.06662940979003906
182,252,173,215,0,0.0,182.5,360,96,252.5,96,145,96,360,269,145,269,360,0.06607723236083984
184,254,171,208,0,0.0,184.5,358,99,254.0,99,150,99,358,270,150,270,358,0.0672159194946289
186,261,170,213,0,0.2540000081062317,186.0,368,101,261.5,101,155,101,368,271,155,271,368,0.06695342063903809
187,267,169,214,0,0.2630000114440918,187.5,374,103,267.0,103,160,103,374,272,160,272,374,0.06561899185180664
189,271,168,212,0,0.2630000114440918,189.0,377,105,271.0,105,165,105,377,273,165,273,377,0.06732964515686035
191,271,166,203,0,0.2639999985694885,191.0,373,108,271.5,108,170,108,373,274,170,274,373,0.0670328140258789
193,278,164,204,0,0.26900002360343933,193.0,380,111,278.0,111,176,111,380,275,176,275,380,0.0656130313873291
196,279,162,195,0,0.2720000147819519,196.0,377,115,279.5,115,182,115,377,277,182,277,377,0.06742715835571289
197,283,159,190,0,0.27300000190734863,197.5,378,118,283.0,118,188,118,378,277,188,277,378,0.06720161437988281
199,289,158,188,0,0.27800002694129944,199.0,383,120,289.0,120,195,120,383,278,195,278,383,0.06645846366882324
201,293,157,186,0,0.0,201.5,386,123,293.0,123,200,123,386,280,200,280,386,0.06621980667114258
204,298,154,184,0,0.0,204.0,390,127,298.0,127,206,127,390,281,206,281,390,0.06592178344726562
205,304,151,180,0,0.30000001192092896,205.5,394,130,304.0,130,214,130,394,281,214,281,394,0.06733345985412598
207,312,149,182,0,0.0,207.5,403,133,312.0,133,221,133,403,282,221,282,403,0.06596922874450684
209,315,146,177,0,0.3150000274181366,209.0,404,136,315.5,136,227,136,404,282,227,282,404,0.06703662872314453
211,321,144,177,0,0.0,211.0,410,139,321.5,139,233,139,410,283,233,283,410,0.06571388244628906
212,325,142,174,0,0.0,212.0,412,141,325.0,141,238,141,412,283,238,283,412,0.067047119140625
213,328,141,171,0,0.0,213.5,414,143,328.5,143,243,143,414,284,243,284,414,0.06651878356933594
215,331,138,167,0,0.0,215.0,415,146,331.5,146,248,146,415,284,248,284,415,0.0658576488494873
216,334,136,163,0,0.0,216.0,416,148,334.5,148,253,148,416,284,253,284,416,0.0674436092376709
216,342,135,171,0,0.38600000739097595,216.5,428,149,342.5,149,257,149,428,284,257,284,428,0.06604290008544922
217,341,134,162,0,0.39100003242492676,217.0,422,150,341.0,150,260,150,422,284,260,284,422,0.06708884239196777
217,345,133,164,0,0.3930000066757202,217.5,427,151,345.0,151,263,151,427,284,263,284,427,0.06764531135559082
218,347,130,164,0,0.39500001072883606,218.0,429,153,347.0,153,265,153,429,283,265,283,429,0.06498837471008301
218,347,131,157,0,0.398000031709671,218.5,426,153,347.5,153,269,153,426,284,269,284,426,0.06765270233154297
218,348,129,155,0,0.39900001883506775,218.5,426,154,348.5,154,271,154,426,283,271,283,426,0.06606149673461914
218,349,129,154,0,0.4020000100135803,218.5,426,154,349.0,154,272,154,426,283,272,283,426,0.06633710861206055
219,351,128,154,0,0.4050000309944153,219.0,428,155,351.0,155,274,155,428,283,274,283,428,0.06719803810119629
219,351,128,153,0,0.406000018119812,219.0,428,155,351.5,155,275,155,428,283,275,283,428,0.06613779067993164
219,353,127,152,0,0.406000018119812,219.5,429,156,353.0,156,277,156,429,283,277,283,429,0.06684637069702148
219,354,127,151,0,0.4090000092983246,219.5,430,156,354.5,156,279,156,430,283,279,283,430,0.06631708145141602
220,355,126,150,0,0.40800002217292786,220.0,430,157,355.0,157,280,157,430,283,280,283,430,0.06629443168640137
220,356,126,150,0,0.4100000262260437,220.0,431,157,356.0,157,281,157,431,283,281,283,431,0.0691840648651123
220,356,126,150,0,0.4100000262260437,220.0,431,157,356.0,157,281,157,431,283,281,283,431,0.06430244445800781
220,356,126,149,0,0.41100001335144043,220.0,431,157,356.5,157,282,157,431,283,282,283,431,0.0682075023651123
220,356,126,149,0,0.41200003027915955,220.0,431,157,356.5,157,282,157,431,283,282,283,431,0.06476020812988281
220,356,126,150,0,0.4100000262260437,220.0,431,157,356.0,157,281,157,431,283,281,283,431,0.06663393974304199
221,356,126,149,0,0.41100001335144043,221.0,431,158,356.5,158,282,158,431,284,282,284,431,0.06666946411132812
222,356,125,149,0,0.41200003027915955,222.5,431,160,356.5,160,282,160,431,285,282,285,431,0.06667327880859375
224,356,125,149,0,0.41200003027915955,224.5,431,162,356.5,162,282,162,431,287,282,287,431,0.06633591651916504
227,357,125,150,0,0.41200003027915955,227.5,432,165,357.0,165,282,165,432,290,282,290,432,0.06696510314941406
230,357,125,149,0,0.4100000262260437,230.5,432,168,357.5,168,283,168,432,293,283,293,432,0.06658530235290527
234,357,125,148,0,0.4140000343322754,234.5,431,172,357.0,172,283,172,431,297,283,297,431,0.06647825241088867
239,356,123,147,0,0.4130000174045563,239.5,430,178,356.5,178,283,178,430,301,283,301,430,0.06659698486328125
244,358,123,146,0,0.4140000343322754,244.5,431,183,358.0,183,285,183,431,306,285,306,431,0.0663764476776123
251,357,125,147,0,0.41100001335144043,251.5,431,189,357.5,189,284,189,431,314,284,314,431,0.06705904006958008
259,358,124,147,0,0.4130000174045563,259.0,432,197,358.5,197,285,197,432,321,285,321,432,0.06623148918151855
266,359,123,147,0,0.41100001335144043,266.5,433,205,359.5,205,286,205,433,328,286,328,433,0.06782126426696777
275,359,121,147,0,0.4130000174045563,275.5,433,215,359.5,215,286,215,433,336,286,336,433,0.06603455543518066
284,359,122,147,0,0.4180000126361847,284.0,433,223,359.5,223,286,223,433,345,286,345,433,0.06616950035095215
294,360,122,146,0,0.42100003361701965,294.0,433,233,360.0,233,287,233,433,355,287,355,433,0.06697726249694824
305,360,121,145,0,0.42500001192092896,305.5,433,245,360.5,245,288,245,433,366,288,366,433,0.06628012657165527
316,361,122,146,0,0.42600002884864807,316.0,434,255,361.0,255,288,255,434,377,288,377,434,0.0671696662902832
328,361,122,146,0,0.42500001192092896,328.0,434,267,361.0,267,288,267,434,389,288,389,434,0.06677055358886719
341,362,120,146,0,0.42500001192092896,341.0,435,281,362.0,281,289,281,435,401,289,401,435,0.06585288047790527
353,361,122,145,0,0.4270000159740448,353.0,434,292,361.5,292,289,292,434,414,289,414,434,0.0669546127319336
365,361,122,145,0,0.4280000329017639,365.0,434,304,361.5,304,289,304,434,426,289,426,434,0.06655335426330566
376,363,124,146,0,0.4300000071525574,376.0,436,314,363.0,314,290,314,436,438,290,438,436,0.06658792495727539
385,362,123,145,0,0.43300002813339233,385.5,435,324,362.5,324,290,324,435,447,290,447,435,0.06699848175048828
394,363,125,147,0,0.43300002813339233,394.5,437,332,363.5,332,290,332,437,457,290,457,437,0.06580281257629395
403,362,127,145,0,0.43800002336502075,403.5,435,340,362.5,340,290,340,435,467,290,467,435,0.0681619644165039
411,362,128,145,0,0.4390000104904175,411.0,435,347,362.5,347,290,347,435,475,290,475,435,0.06546688079833984
418,362,130,144,0,0.4440000355243683,418.0,434,353,362.0,353,290,353,434,483,290,483,434,0.06685018539428711
424,363,129,145,0,0.445000022649765,424.5,436,360,363.5,360,291,360,436,489,291,489,436,0.06815028190612793
430,363,130,144,0,0.445000022649765,430.0,435,365,363.0,365,291,365,435,495,291,495,435,0.06456446647644043
435,362,130,143,0,0.4480000138282776,435.0,434,370,362.5,370,291,370,434,500,291,500,434,0.06709694862365723
439,362,131,144,0,0.4490000307559967,439.5,434,374,362.0,374,290,374,434,505,290,505,434,0.06677079200744629
443,362,131,143,0,0.45000001788139343,443.5,434,378,362.5,378,291,378,434,509,291,509,434,0.06655216217041016
446,362,132,144,0,0.45100003480911255,446.0,434,380,362.0,380,290,380,434,512,290,512,434,0.06674790382385254
449,362,132,143,0,0.4540000259876251,449.0,434,383,362.5,383,291,383,434,515,291,515,434,0.06718850135803223
450,362,133,143,0,0.453000009059906,450.5,434,384,362.5,384,291,384,434,517,291,517,434,0.06765151023864746
451,362,133,144,0,0.453000009059906,451.5,434,385,362.0,385,290,385,434,518,290,518,434,0.06538128852844238
452,362,134,144,0,0.45100003480911255,452.0,434,385,362.0,385,290,385,434,519,290,519,434,0.06836986541748047
451,362,133,144,0,0.4520000219345093,451.5,434,385,362.0,385,290,385,434,518,290,518,434,0.0648338794708252
452,362,134,143,0,0.453000009059906,452.0,434,385,362.5,385,291,385,434,519,291,519,434,0.06562352180480957
452,362,133,144,0,0.45100003480911255,452.5,434,386,362.0,386,290,386,434,519,290,519,434,0.06725740432739258
453,361,134,143,0,0.4520000219345093,453.0,433,386,361.5,386,290,386,433,520,290,520,433,0.06663036346435547
454,361,134,145,0,0.4520000219345093,454.0,434,387,361.5,387,289,387,434,521,289,521,434,0.06682276725769043
454,361,135,145,0,0.4490000307559967,454.5,434,387,361.5,387,289,387,434,522,289,522,434,0.06707429885864258
456,361,136,146,0,0.4480000138282776,456.0,434,388,361.0,388,288,388,434,524,288,524,434,0.0659027099609375
457,359,137,145,0,0.44700002670288086,457.5,432,389,359.5,389,287,389,432,526,287,526,432,0.06760549545288086
459,358,137,147,0,0.44600000977516174,459.5,432,391,358.5,391,285,391,432,528,285,528,432,0.0658111572265625
461,357,138,148,0,0.4440000355243683,461.0,431,392,357.0,392,283,392,431,530,283,530,431,0.06692147254943848
462,355,139,147,0,0.44200003147125244,462.5,429,393,355.5,393,282,393,429,532,282,532,429,0.06713724136352539
465,353,140,149,0,0.44200003147125244,465.0,428,395,353.5,395,279,395,428,535,279,535,428,0.0654764175415039
467,351,142,150,0,0.44200003147125244,467.0,426,396,351.0,396,276,396,426,538,276,538,426,0.06879973411560059
471,348,144,153,0,0.43800002336502075,471.0,425,399,348.5,399,272,399,425,543,272,543,425,0.09990239143371582
474,347,145,154,0,0.4360000193119049,474.5,424,402,347.0,402,270,402,424,547,270,547,424,0.06566977500915527
476,344,147,157,0,0.4310000240802765,476.5,423,403,344.5,403,266,403,423,550,266,550,423,0.06676220893859863
479,341,149,160,0,0.42900002002716064,479.5,421,405,341.0,405,261,405,421,554,261,554,421,0.06744742393493652
483,337,152,161,0,0.4280000329017639,483.0,418,407,337.5,407,257,407,418,559,257,559,418,0.06661009788513184
486,336,155,164,0,0.4240000247955322,486.5,418,409,336.0,409,254,409,418,564,254,564,418,0.06662321090698242
490,332,158,167,0,0.42000001668930054,490.0,416,411,332.5,411,249,411,416,569,249,569,416,0.06647729873657227
493,330,161,174,0,0.4150000214576721,493.5,417,413,330.0,413,243,413,417,574,243,574,417,0.06649613380432129
496,327,163,176,0,0.4130000174045563,496.5,415,415,327.0,415,239,415,415,578,239,578,415,0.06670522689819336
499,319,165,171,0,0.4150000214576721,499.5,405,417,319.5,417,234,417,405,582,234,582,405,0.06610441207885742
502,315,167,173,0,0.4150000214576721,502.5,402,419,315.5,419,229,419,402,586,229,586,402,0.06597042083740234
506,313,170,177,0,0.40800002217292786,506.0,402,421,313.5,421,225,421,402,591,225,591,402,0.0673677921295166
508,310,172,179,0,0.40800002217292786,508.0,400,422,310.5,422,221,422,400,594,221,594,400,0.06721115112304688
510,307,173,182,0,0.40700000524520874,510.5,398,424,307.0,424,216,424,398,597,216,597,398,0.06462430953979492
512,306,175,189,0,0.4020000100135803,512.5,401,425,306.5,425,212,425,401,600,212,600,401,0.06666135787963867
514,308,177,200,0,0.398000031709671,514.5,408,426,308.0,426,208,426,408,603,208,603,408,0.06693553924560547
516,303,178,194,0,0.39900001883506775,516.0,400,427,303.0,427,206,427,400,605,206,605,400,0.06604433059692383
517,295,180,186,0,0.40300002694129944,517.0,388,427,295.0,427,202,427,388,607,202,607,388,0.06637740135192871
518,290,181,183,0,0.4050000309944153,518.5,382,428,290.5,428,199,428,382,609,199,609,382,0.06665277481079102
520,289,182,184,0,0.4000000059604645,520.0,381,429,289.0,429,197,429,381,611,197,611,381,0.06650924682617188
520,287,183,184,0,0.4010000228881836,520.5,379,429,287.0,429,195,429,379,612,195,612,379,0.0667562484741211
522,286,184,186,0,0.40300002694129944,522.0,379,430,286.0,430,193,430,379,614,193,614,379,0.06599164009094238
523,286,184,189,0,0.398000031709671,523.0,381,431,286.5,431,192,431,381,615,192,615,381,0.06733560562133789
523,285,184,190,0,0.398000031709671,523.0,380,431,285.0,431,190,431,380,615,190,615,380,0.06627321243286133
523,285,185,192,0,0.3970000147819519,523.5,381,431,285.0,431,189,431,381,616,189,616,381,0.06682872772216797
524,284,186,190,0,0.3970000147819519,524.0,379,431,284.0,431,189,431,379,617,189,617,379,0.0660097599029541
523,286,185,194,0,0.39400002360343933,523.5,383,431,286.0,431,189,431,383,616,189,616,383,0.0673360824584961
523,284,185,190,0,0.3970000147819519,523.5,379,431,284.0,431,189,431,379,616,189,616,379,0.0661008358001709
522,286,186,195,0,0.398000031709671,522.0,384,429,286.5,429,189,429,384,615,189,615,384,0.0664665699005127
521,284,186,191,0,0.39500001072883606,521.0,380,428,284.5,428,189,428,380,614,189,614,380,0.06710290908813477
520,284,186,188,0,0.3960000276565552,520.0,378,427,284.0,427,190,427,378,613,190,613,378,0.06629323959350586
518,284,186,187,0,0.3970000147819519,518.0,378,425,284.5,425,191,425,378,611,191,611,378,0.06676959991455078
515,286,186,188,0,0.39400002360343933,515.0,380,422,286.0,422,192,422,380,608,192,608,380,0.06698775291442871
511,287,185,188,0,0.39000001549720764,511.5,381,419,287.0,419,193,419,381,604,193,604,381,0.06653547286987305
507,288,187,189,0,0.39000001549720764,507.5,383,414,288.5,414,194,414,383,601,194,601,383,0.06650114059448242
502,290,187,190,0,0.38600000739097595,502.5,385,409,290.0,409,195,409,385,596,195,596,385,0.06751847267150879
498,293,187,193,0,0.3830000162124634,498.5,390,405,293.5,405,197,405,390,592,197,592,390,0.06609725952148438
492,294,185,193,0,0.3800000250339508,492.5,391,400,294.5,400,198,400,391,585,198,585,391,0.06755304336547852
487,297,186,195,0,0.3760000169277191,487.0,395,394,297.5,394,200,394,395,580,200,580,395,0.06749820709228516
480,301,186,195,0,0.3720000088214874,480.0,399,387,301.5,387,204,387,399,573,204,573,399,0.0660867691040039
471,305,185,196,0,0.367000013589859,471.5,403,379,305.0,379,207,379,403,564,207,564,403,0.0682070255279541
463,307,185,197,0,0.36400002241134644,463.5,406,371,307.5,371,209,371,406,556,209,556,406,0.0644078254699707
454,310,185,199,0,0.359000027179718,454.5,410,362,310.5,362,211,362,410,547,211,547,410,0.06769800186157227
444,315,184,201,0,0.3540000021457672,444.0,416,352,315.5,352,215,352,416,536,215,536,416,0.06525802612304688
433,320,184,202,0,0.34800001978874207,433.0,421,341,320.0,341,219,341,421,525,219,525,421,0.0655202865600586
421,324,182,203,0,0.34200000762939453,421.0,426,330,324.5,330,223,330,426,512,223,512,426,0.0674293041229248
407,330,182,206,0,0.33500000834465027,407.0,433,316,330.0,316,227,316,433,498,227,498,433,0.06562614440917969
394,335,180,207,0,0.3320000171661377,394.0,439,304,335.5,304,232,304,439,484,232,484,439,0.06740474700927734
377,341,181,209,0,0.32500001788139343,377.5,446,287,341.5,287,237,287,446,468,237,468,446,0.06566500663757324
360,347,183,210,0,0.320000022649765,360.5,452,269,347.0,269,242,269,452,452,242,452,452,0.06609034538269043
342,353,185,212,0,0.3150000274181366,342.5,459,250,353.0,250,247,250,459,435,247,435,459,0.06730151176452637
326,358,184,213,0,0.3110000193119049,326.0,465,234,358.5,234,252,234,465,418,252,418,465,0.06650924682617188
308,363,188,213,0,0.0,308.0,470,214,363.5,214,257,214,470,402,257,402,470,0.06649017333984375
292,369,190,216,0,0.0,292.0,477,197,369.0,197,261,197,477,387,261,387,477,0.06665682792663574
275,372,191,215,0,0.0,275.5,480,180,372.5,180,265,180,480,371,265,371,480,0.06631588935852051
260,374,192,211,0,0.0,260.0,480,164,374.5,164,269,164,480,356,269,356,480,0.06702113151550293
245,376,195,208,0,0.0,245.5,480,148,376.0,148,272,148,480,343,272,343,480,0.06656503677368164
231,378,196,204,0,0.0,231.0,480,133,378.0,133,276,133,480,329,276,329,480,0.06616020202636719
218,379,198,201,0,0.2110000103712082,218.0,480,119,379.5,119,279,119,480,317,279,317,480,0.06716156005859375
206,380,200,197,0,0.0,206.0,479,106,380.5,106,282,106,479,306,282,306,479,0.06604528427124023
194,382,202,194,0,0.0,194.0,479,93,382.0,93,285,93,479,295,285,295,479,0.06796860694885254
184,383,203,192,0,0.0,184.5,479,83,383.0,83,287,83,479,286,287,286,479,0.06563925743103027
175,384,204,189,0,0.0,175.0,479,73,384.5,73,290,73,479,277,290,277,479,0.06628012657165527
167,385,204,188,0,0.0,167.0,479,65,385.0,65,291,65,479,269,291,269,479,0.06697964668273926
159,385,207,187,0,0.0,159.5,479,56,385.5,56,292,56,479,263,292,263,479,0.06661772727966309
153,386,207,185,0,0.0,153.5,479,50,386.5,50,294,50,479,257,294,257,479,0.06689047813415527
148,387,208,184,0,0.0,148.0,479,44,387.0,44,295,44,479,252,295,252,479,0.06667780876159668
144,387,208,183,0,0.0,144.0,479,40,387.5,40,296,40,479,248,296,248,479,0.06578993797302246
142,387,208,183,0,0.0,142.0,479,38,387.5,38,296,38,479,246,296,246,479,0.0665733814239502
141,388,208,182,0,0.0,141.0,479,37,388.0,37,297,37,479,245,297,245,479,0.06645798683166504
140,388,209,182,0,0.0,140.5,479,36,388.0,36,297,36,479,245,297,245,479,0.06677055358886719
142,388,208,182,0,0.0,142.0,479,38,388.0,38,297,38,479,246,297,246,479,0.06725358963012695
142,387,209,183,0,0.0,142.5,479,38,387.5,38,296,38,479,247,296,247,479,0.06767868995666504
145,387,208,183,0,0.0,145.0,479,41,387.5,41,296,41,479,249,296,249,479,0.0654301643371582
149,386,208,185,0,0.0,149.0,479,45,386.5,45,294,45,479,253,294,253,479,0.09881591796875
157,385,206,187,0,0.0,157.0,479,54,385.5,54,292,54,479,260,292,260,479,0.06756019592285156
162,384,205,190,0,0.0,162.5,479,60,384.0,60,289,60,479,265,289,265,479,0.06620192527770996
170,383,203,192,0,0.20800000429153442,170.5,479,69,383.0,69,287,69,479,272,287,272,479,0.06680178642272949
178,381,203,195,0,0.0,178.5,479,77,381.5,77,284,77,479,280,284,280,479,0.06720495223999023
188,380,200,198,0,0.0,188.0,479,88,380.0,88,281,88,479,288,281,288,479,0.06588602066040039
197,378,199,202,0,0.2150000035762787,197.5,479,98,378.0,98,277,98,479,297,277,297,479,0.06702351570129395
208,376,198,206,0,0.0,208.0,479,109,376.0,109,273,109,479,307,273,307,479,0.06614255905151367
219,373,195,211,0,0.0,219.5,479,122,373.5,122,268,122,479,317,268,317,479,0.0671243667602539
232,371,194,215,0,0.22100001573562622,232.0,479,135,371.5,135,264,135,479,329,264,329,479,0.06670641899108887
245,367,190,216,0,0.0,245.0,475,150,367.0,150,259,150,475,340,259,340,475,0.06630730628967285
258,360,189,213,0,0.0,258.5,467,164,360.5,164,254,164,467,353,254,353,467,0.06687521934509277
272,355,185,212,0,0.0,272.5,461,180,355.0,180,249,180,461,365,249,365,461,0.06688928604125977
286,348,184,212,0,0.0,286.0,454,194,348.0,194,242,194,454,378,242,378,454,0.06587767601013184
301,341,182,210,0,0.0,301.0,446,210,341.0,210,236,210,446,392,236,392,446,0.06676340103149414
315,333,181,207,0,0.0,315.5,437,225,333.5,225,230,225,437,406,230,406,437,0.06678485870361328
330,326,178,206,0,0.0,330.0,429,241,326.0,241,223,241,429,419,223,419,429,0.0663003921508789
345,319,177,204,0,0.33000001311302185,345.5,421,257,319.0,257,217,257,421,434,217,434,421,0.06683230400085449
360,310,174,201,0,0.3360000252723694,360.0,411,273,310.5,273,210,273,411,447,210,447,411,0.0669260025024414
375,303,172,200,0,0.34300002455711365,375.0,403,289,303.0,289,203,289,403,461,203,461,403,0.06661033630371094
390,294,170,199,0,0.35200002789497375,390.0,394,305,294.5,305,195,305,394,475,195,475,394,0.06694626808166504
404,286,170,197,0,0.3580000102519989,404.0,385,319,286.5,319,188,319,385,489,188,489,385,0.06638598442077637
416,277,171,195,0,0.3680000305175781,416.5,375,331,277.5,331,180,331,375,502,180,502,375,0.06527328491210938
428,271,171,194,0,0.37800002098083496,428.5,368,343,271.0,343,174,343,368,514,174,514,368,0.06754684448242188
439,264,172,194,0,0.3830000162124634,439.0,361,353,264.0,353,167,353,361,525,167,525,361,0.06670880317687988
449,257,172,190,0,0.39100003242492676,449.0,352,363,257.0,363,162,363,352,535,162,535,352,0.06593084335327148
458,251,172,190,0,0.398000031709671,458.0,346,372,251.0,372,156,372,346,544,156,544,346,0.06726217269897461
466,246,172,189,0,0.40400001406669617,466.0,341,380,246.5,380,152,380,341,552,152,552,341,0.06649613380432129
473,240,173,189,0,0.41200003027915955,473.5,335,387,240.5,387,146,387,335,560,146,560,335,0.06683826446533203
481,236,172,187,0,0.42100003361701965,481.0,330,395,236.5,395,143,395,330,567,143,567,330,0.06600832939147949
487,232,172,184,0,0.4270000159740448,487.0,324,401,232.0,401,140,401,324,573,140,573,324,0.07058405876159668
492,227,172,183,0,0.4350000321865082,492.0,319,406,227.5,406,136,406,319,578,136,578,319,0.06316113471984863
496,224,171,183,0,0.4400000274181366,496.5,316,411,224.5,411,133,411,316,582,133,582,316,0.06612801551818848
501,221,171,183,0,0.445000022649765,501.5,313,416,221.5,416,130,416,313,587,130,587,313,0.0663299560546875
506,218,172,181,0,0.4480000138282776,506.0,309,420,218.5,420,128,420,309,592,128,592,309,0.06702828407287598
510,217,170,180,0,0.45500001311302185,510.0,307,425,217.0,425,127,425,307,595,127,595,307,0.06664848327636719
513,214,171,181,0,0.46000000834465027,513.5,305,428,214.5,428,124,428,305,599,124,599,305,0.06682062149047852
516,212,169,181,0,0.4570000171661377,516.5,303,432,212.5,432,122,432,303,601,122,601,303,0.06652593612670898
519,211,170,181,0,0.4620000123977661,519.0,302,434,211.5,434,121,434,302,604,121,604,302,0.06624460220336914
522,208,170,179,0,0.46800002455711365,522.0,298,437,208.5,437,119,437,298,607,119,607,298,0.06692290306091309
523,207,169,178,0,0.47200003266334534,523.5,296,439,207.0,439,118,439,296,608,118,608,296,0.06633591651916504
525,205,168,178,0,0.4750000238418579,525.0,294,441,205.0,441,116,441,294,609,116,609,294,0.06637382507324219
527,204,168,176,0,0.47600001096725464,527.0,292,443,204.0,443,116,443,292,611,116,611,292,0.0671839714050293
528,203,168,177,0,0.48100003600120544,528.0,292,444,203.5,444,115,444,292,612,115,612,292,0.06618523597717285
528,203,167,176,0,0.48500001430511475,528.5,291,445,203.0,445,115,445,291,612,115,612,291,0.06649971008300781
529,205,167,182,0,0.4820000231266022,529.5,296,446,205.0,446,114,446,296,613,114,613,296,0.06646323204040527
530,203,167,179,0,0.48000001907348633,530.5,293,447,203.5,447,114,447,293,614,114,614,293,0.06696653366088867
530,204,166,180,0,0.484000027179718,530.0,294,447,204.0,447,114,447,294,613,114,613,294,0.06667566299438477
529,206,167,184,0,0.48100003600120544,529.5,298,446,206.0,446,114,446,298,613,114,613,298,0.06677532196044922
529,204,166,179,0,0.48000001907348633,529.0,294,446,204.5,446,115,446,294,612,115,612,294,0.06605339050292969
527,204,167,177,0,0.4870000183582306,527.5,293,444,204.5,444,116,444,293,611,116,611,293,0.06748628616333008
525,205,166,175,0,0.48000001907348633,525.0,293,442,205.5,442,118,442,293,608,118,608,293,0.06621003150939941
523,210,166,176,0,0.4740000367164612,523.0,298,440,210.0,440,122,440,298,606,122,606,298,0.06675863265991211
519,218,166,184,0,0.4710000157356262,519.0,310,436,218.0,436,126,436,310,602,126,602,310,0.06587672233581543
514,218,163,177,0,0.4740000367164612,514.5,307,433,218.5,433,130,433,307,596,130,596,307,0.06871175765991211
509,219,162,173,0,0.47200003266334534,509.0,306,428,219.5,428,133,428,306,590,133,590,306,0.06487774848937988
503,225,160,172,0,0.46800002455711365,503.0,311,423,225.0,423,139,423,311,583,139,583,311,0.06595969200134277
496,234,159,178,0,0.4650000333786011,496.5,323,417,234.0,417,145,417,323,576,145,576,323,0.06701159477233887
490,236,157,172,0,0.46300002932548523,490.5,322,412,236.0,412,150,412,322,569,150,569,322,0.0666968822479248
482,245,156,172,0,0.46000000834465027,482.0,331,404,245.0,404,159,404,331,560,159,560,331,0.06688332557678223
473,249,152,169,0,0.4620000123977661,473.0,334,397,249.5,397,165,397,334,549,165,549,334,0.06624221801757812
464,257,150,171,0,0.45600003004074097,464.0,343,389,257.5,389,172,389,343,539,172,539,343,0.06630182266235352
453,263,147,165,0,0.4580000340938568,453.5,346,380,263.5,380,181,380,346,527,181,527,346,0.06684303283691406
442,272,143,161,0,0.453000009059906,442.5,353,371,272.5,371,192,371,353,514,192,514,353,0.06603455543518066
431,279,140,160,0,0.453000009059906,431.0,359,361,279.0,361,199,361,359,501,199,501,359,0.06698203086853027
421,286,136,156,0,0.4540000259876251,421.0,364,353,286.0,353,208,353,364,489,208,489,364,0.06709980964660645
411,293,132,157,0,0.4490000307559967,411.0,372,345,293.5,345,215,345,372,477,215,477,372,0.06595158576965332
401,300,129,154,0,0.44600000977516174,401.5,377,337,300.0,337,223,337,377,466,223,466,377,0.06727123260498047
393,305,128,152,0,0.4490000307559967,393.0,381,329,305.0,329,229,329,381,457,229,457,381,0.06611394882202148
385,309,124,149,0,0.44700002670288086,385.0,384,323,309.5,323,235,323,384,447,235,447,384,0.06625986099243164
378,314,122,149,0,0.44300001859664917,378.0,389,317,314.5,317,240,317,389,439,240,439,389,0.06752586364746094
370,318,121,148,0,0.44300001859664917,370.5,392,310,318.0,310,244,310,392,431,244,431,392,0.06587672233581543
365,321,118,146,0,0.4400000274181366,365.0,394,306,321.0,306,248,306,394,424,248,424,394,0.06750893592834473
360,324,118,144,0,0.44300001859664917,360.0,396,301,324.0,301,252,301,396,419,252,419,396,0.06567811965942383
355,327,118,144,0,0.445000022649765,355.0,399,296,327.0,296,255,296,399,414,255,414,399,0.06899666786193848
351,329,116,142,0,0.445000022649765,351.0,400,293,329.0,293,258,293,400,409,258,409,400,0.06463098526000977
348,330,114,142,0,0.445000022649765,348.0,401,291,330.0,291,259,291,401,405,259,405,401,0.06689643859863281
346,331,114,141,0,0.445000022649765,346.0,402,289,331.5,289,261,289,402,403,261,403,402,0.06690692901611328
344,332,114,141,0,0.44700002670288086,344.0,403,287,332.5,287,262,287,403,401,262,401,403,0.06659460067749023
343,332,114,141,0,0.4480000138282776,343.0,403,286,332.5,286,262,286,403,400,262,400,403,0.06558918952941895
343,332,114,141,0,0.4480000138282776,343.0,403,286,332.5,286,262,286,403,400,262,400,403,0.06729555130004883
343,332,114,140,0,0.4490000307559967,343.0,402,286,332.0,286,262,286,402,400,262,400,402,0.06589078903198242
342,331,115,139,0,0.4490000307559967,342.5,401,285,331.5,285,262,285,401,400,262,400,401,0.06670284271240234
341,332,114,140,0,0.44700002670288086,341.0,402,284,332.0,284,262,284,402,398,262,398,402,0.06625056266784668
339,331,114,141,0,0.4490000307559967,339.0,402,282,331.5,282,261,282,402,396,261,396,402,0.06702113151550293
338,330,114,142,0,0.45000001788139343,338.0,401,281,330.0,281,259,281,401,395,259,395,401,0.06687259674072266
335,329,114,142,0,0.45100003480911255,335.0,400,278,329.0,278,258,278,400,392,258,392,400,0.06624722480773926
331,328,114,141,0,0.453000009059906,331.0,399,274,328.5,274,258,274,399,388,258,388,399,0.0669713020324707
327,327,114,140,0,0.45500001311302185,327.0,397,270,327.0,270,257,270,397,384,257,384,397,0.06632399559020996
322,325,113,140,0,0.45500001311302185,322.5,395,266,325.0,266,255,266,395,379,255,379,395,0.06650567054748535
317,323,114,138,0,0.4540000259876251,317.0,392,260,323.0,260,254,260,392,374,254,374,392,0.06662940979003906
312,321,113,139,0,0.0,312.5,391,256,321.5,256,252,256,391,369,252,369,391,0.06640005111694336
306,318,113,140,0,0.43400001525878906,306.5,388,250,318.0,250,248,250,388,363,248,363,388,0.06703662872314453
301,315,112,140,0,0.42000001668930054,301.0,385,245,315.0,245,245,245,385,357,245,357,385,0.06623268127441406
294,312,113,141,0,0.42000001668930054,294.5,383,238,312.5,238,242,238,383,351,242,351,383,0.06691431999206543
287,309,112,139,0,0.41700002551078796,287.0,379,231,309.5,231,240,231,379,343,240,343,379,0.06663894653320312
280,305,112,139,0,0.4090000092983246,280.0,375,224,305.5,224,236,224,375,336,236,336,375,0.06676816940307617
273,301,112,137,0,0.406000018119812,273.0,370,217,301.5,217,233,217,370,329,233,329,370,0.06737613677978516
264,298,111,139,0,0.4100000262260437,264.5,368,209,298.5,209,229,209,368,320,229,320,368,0.06679916381835938
256,295,112,140,0,0.4140000343322754,256.0,365,200,295.0,200,225,200,365,312,225,312,365,0.0654299259185791
247,294,113,145,0,0.4220000207424164,247.5,367,191,294.5,191,222,191,367,304,222,304,367,0.06675195693969727
239,285,112,137,0,0.4140000343322754,239.0,354,183,285.5,183,217,183,354,295,217,295,354,0.0668952465057373
229,280,112,139,0,0.41600000858306885,229.0,350,173,280.5,173,211,173,350,285,211,285,350,0.06620669364929199
220,275,111,138,0,0.44300001859664917,220.5,344,165,275.0,165,206,165,344,276,206,276,344,0.06705570220947266
211,270,111,136,0,0.0,211.5,338,156,270.0,156,202,156,338,267,202,267,338,0.06649637222290039
204,267,112,142,0,0.47700002789497375,204.0,338,148,267.0,148,196,148,338,260,196,260,338,0.06687378883361816
195,261,111,140,0,0.4780000150203705,195.5,331,140,261.0,140,191,140,331,251,191,251,331,0.06684303283691406
189,255,110,137,0,0.0,189.0,324,134,255.5,134,187,134,324,244,187,244,324,0.06677079200744629
182,250,111,137,0,0.484000027179718,182.5,319,127,250.5,127,182,127,319,238,182,238,319,0.06612825393676758
176,246,111,138,0,0.0,176.5,315,121,246.0,121,177,121,315,232,177,232,315,0.06655240058898926
170,243,111,138,0,0.0,170.5,312,115,243.0,115,174,115,312,226,174,226,312,0.06638097763061523
165,240,111,138,0,0.5020000338554382,165.5,309,110,240.0,110,171,110,309,221,171,221,309,0.06708168983459473
160,236,111,136,0,0.49900001287460327,160.5,304,105,236.0,105,168,105,304,216,168,216,304,0.06609606742858887
156,233,110,138,0,0.5,156.0,302,101,233.0,101,164,101,302,211,164,211,302,0.06695437431335449
152,230,110,138,0,0.5020000338554382,152.0,299,97,230.0,97,161,97,299,207,161,207,299,0.06665539741516113
149,228,110,141,0,0.5020000338554382,149.0,299,94,228.5,94,158,94,299,204,158,204,299,0.06699872016906738
145,224,111,139,0,0.5070000290870667,145.5,294,90,224.5,90,155,90,294,201,155,201,294,0.06654596328735352
143,222,111,137,0,0.5100000500679016,143.5,291,88,222.5,88,154,88,291,199,154,199,291,0.06615304946899414
140,222,110,141,0,0.5049999952316284,140.0,293,85,222.5,85,152,85,293,195,152,195,293,0.06662559509277344
137,220,111,143,0,0.5049999952316284,137.5,292,82,220.5,82,149,82,292,193,149,193,292,0.06681084632873535
136,217,111,141,0,0.5110000371932983,136.5,288,81,217.5,81,147,81,288,192,147,192,288,0.06728696823120117
135,214,110,137,0,0.5100000500679016,135.0,283,80,214.5,80,146,80,283,190,146,190,283,0.06598114967346191
134,214,110,139,0,0.5139999985694885,134.0,284,79,214.5,79,145,79,284,189,145,189,284,0.06804323196411133
133,214,110,138,0,0.5110000371932983,133.0,283,78,214.0,78,145,78,283,188,145,188,283,0.06588602066040039
133,213,110,137,0,0.5139999985694885,133.0,282,78,213.5,78,145,78,282,188,145,188,282,0.06528782844543457
133,216,110,143,0,0.5130000114440918,133.0,288,78,216.5,78,145,78,288,188,145,188,288,0.0666658878326416
133,214,110,139,0,0.5100000500679016,133.0,284,78,214.5,78,145,78,284,188,145,188,284,0.06703901290893555
134,214,110,138,0,0.5120000243186951,134.0,283,79,214.0,79,145,79,283,189,145,189,283,0.06671023368835449
135,214,110,139,0,0.5080000162124634,135.0,284,80,214.5,80,145,80,284,190,145,190,284,0.06639432907104492
136,213,111,137,0,0.5130000114440918,136.5,282,81,213.5,81,145,81,282,192,145,192,282,0.06678485870361328
138,215,112,138,0,0.5139999985694885,138.0,284,82,215.0,82,146,82,284,194,146,194,284,0.06632781028747559
140,215,112,139,0,0.0,140.0,285,84,215.5,84,146,84,285,196,146,196,285,0.06728219985961914
143,216,111,139,0,0.5110000371932983,143.5,286,88,216.5,88,147,88,286,199,147,199,286,0.06553101539611816
146,218,112,140,0,0.5049999952316284,146.0,288,90,218.0,90,148,90,288,202,148,202,288,0.0670173168182373
149,218,112,139,0,0.5010000467300415,149.0,288,93,218.5,93,149,93,288,205,149,205,288,0.06759095191955566
153,219,112,140,0,0.5010000467300415,153.0,289,97,219.0,97,149,97,289,209,149,209,289,0.06549310684204102
157,222,113,143,0,0.4960000216960907,157.5,294,101,222.5,101,151,101,294,214,151,214,294,0.06702017784118652
162,222,113,141,0,0.49800002574920654,162.5,293,106,222.5,106,152,106,293,219,152,219,293,0.06691312789916992
168,224,112,141,0,0.0,168.0,295,112,224.5,112,154,112,295,224,154,224,295,0.06614279747009277
174,225,114,142,0,0.0,174.0,296,117,225.0,117,154,117,296,231,154,231,296,0.0664513111114502
180,226,112,142,0,0.0,180.0,297,124,226.0,124,155,124,297,236,155,236,297,0.06690835952758789
187,229,113,146,0,0.39900001883506775,187.5,302,131,229.0,131,156,131,302,244,156,244,302,0.0666968822479248
194,231,113,146,0,0.0,194.5,304,138,231.0,138,158,138,304,251,158,251,304,0.06619024276733398
203,231,114,145,0,0.0,203.0,304,146,231.5,146,159,146,304,260,159,260,304,0.06693911552429199
211,232,114,145,0,0.0,211.0,305,154,232.5,154,160,154,305,268,160,268,305,0.0666353702545166
220,233,117,143,0,0.0,220.5,305,162,233.5,162,162,162,305,279,162,279,305,0.06674337387084961
230,235,117,146,0,0.4390000104904175,230.5,308,172,235.0,172,162,172,308,289,162,289,308,0.06679320335388184
241,236,117,146,0,0.4390000104904175,241.5,309,183,236.0,183,163,183,309,300,163,300,309,0.06627535820007324
253,237,118,148,0,0.43700000643730164,253.0,311,194,237.0,194,163,194,311,312,163,312,311,0.06635260581970215
266,238,118,149,0,0.44200003147125244,266.0,313,207,238.5,207,164,207,313,325,164,325,313,0.06616520881652832
278,239,121,151,0,0.44200003147125244,278.5,315,218,239.5,218,164,218,315,339,164,339,315,0.06711244583129883
293,241,123,152,0,0.0,293.5,317,232,241.0,232,165,232,317,355,165,355,317,0.06734633445739746
308,241,121,153,0,0.44200003147125244,308.5,318,248,241.5,248,165,248,318,369,165,369,318,0.06580901145935059
322,242,123,154,0,0.0,322.5,319,261,242.0,261,165,261,319,384,165,384,319,0.06611990928649902
337,242,126,156,0,0.0,337.0,320,274,242.0,274,164,274,320,400,164,400,320,0.06807327270507812
351,241,126,157,0,0.0,351.0,320,288,241.5,288,163,288,320,414,163,414,320,0.06534004211425781
365,242,128,158,0,0.0,365.0,321,301,242.0,301,163,301,321,429,163,429,321,0.0679628849029541
378,241,129,160,0,0.0,378.5,321,314,241.0,314,161,314,321,443,161,443,321,0.06510233879089355
391,241,132,160,0,0.4580000340938568,391.0,321,325,241.0,325,161,325,321,457,161,457,321,0.06704473495483398
403,240,135,161,0,0.4620000123977661,403.5,321,336,240.5,336,160,336,321,471,160,471,321,0.06647515296936035
415,240,138,162,0,0.4620000123977661,415.0,321,346,240.0,346,159,346,321,484,159,484,321,0.06641435623168945
425,239,141,163,0,0.4610000252723694,425.5,321,355,239.5,355,158,355,321,496,158,496,321,0.06659245491027832
436,239,144,163,0,0.4580000340938568,436.0,321,364,239.5,364,158,364,321,508,158,508,321,0.0664665699005127
446,238,147,166,0,0.4610000252723694,446.5,321,373,238.0,373,155,373,321,520,155,520,321,0.06679201126098633
455,236,149,167,0,0.46000000834465027,455.5,320,381,236.5,381,153,381,320,530,153,530,320,0.06632637977600098
465,235,153,169,0,0.4620000123977661,465.5,320,389,235.5,389,151,389,320,542,151,542,320,0.06782984733581543
473,234,154,170,0,0.46000000834465027,473.0,319,396,234.0,396,149,396,319,550,149,550,319,0.06550979614257812
481,233,157,172,0,0.4610000252723694,481.5,319,403,233.0,403,147,403,319,560,147,560,319,0.06672430038452148
489,231,160,171,0,0.4660000205039978,489.0,317,409,231.5,409,146,409,317,569,146,569,317,0.06643104553222656
496,231,160,172,0,0.4650000333786011,496.0,317,416,231.0,416,145,416,317,576,145,576,317,0.06664490699768066
500,230,161,172,0,0.4610000252723694,500.5,316,420,230.0,420,144,420,316,581,144,581,316,0.06623625755310059
506,228,162,173,0,0.4610000252723694,506.0,315,425,228.5,425,142,425,315,587,142,587,315,0.06714797019958496
510,228,165,172,0,0.4660000205039978,510.5,314,428,228.0,428,142,428,314,593,142,593,314,0.06630158424377441
514,228,165,174,0,0.45900002121925354,514.5,315,432,228.0,432,141,432,315,597,141,597,315,0.06713986396789551
518,227,166,174,0,0.4610000252723694,518.0,314,435,227.0,435,140,435,314,601,140,601,314,0.06653213500976562
520,226,168,175,0,0.46400001645088196,520.0,314,436,226.5,436,139,436,314,604,139,604,314,0.06619596481323242
521,228,167,178,0,0.4620000123977661,521.5,317,438,228.0,438,139,438,317,605,139,605,317,0.06726574897766113
522,229,169,180,0,0.46000000834465027,522.5,319,438,229.0,438,139,438,319,607,139,607,319,0.06789016723632812
522,228,168,179,0,0.45900002121925354,522.0,318,438,228.5,438,139,438,318,606,139,606,318,0.06535983085632324
522,228,168,179,0,0.4650000333786011,522.0,318,438,228.5,438,139,438,318,606,139,606,318,0.06612253189086914
521,228,167,177,0,0.46300002932548523,521.5,317,438,228.5,438,140,438,317,605,140,605,317,0.0666506290435791
520,228,168,177,0,0.46400001645088196,520.0,317,436,228.5,436,140,436,317,604,140,604,317,0.0666494369506836
518,230,166,176,0,0.4620000123977661,518.0,318,435,230.0,435,142,435,318,601,142,601,318,0.06637024879455566
515,229,165,172,0,0.4620000123977661,515.5,315,433,229.0,433,143,433,315,598,143,598,315,0.06680727005004883
512,230,163,173,0,0.46700000762939453,512.5,317,431,230.5,431,144,431,317,594,144,594,317,0.0670933723449707
508,232,162,173,0,0.46400001645088196,508.0,319,427,232.5,427,146,427,319,589,146,589,319,0.06568646430969238
504,235,160,174,0,0.46700000762939453,504.0,322,424,235.0,424,148,424,322,584,148,584,322,0.06673717498779297
499,235,158,171,0,0.46700000762939453,499.0,321,420,235.5,420,150,420,321,578,150,578,321,0.06800413131713867
494,237,157,169,0,0.46700000762939453,494.5,322,416,237.5,416,153,416,322,573,153,573,322,0.06519508361816406
489,239,156,167,0,0.4710000157356262,489.0,323,411,239.5,411,156,411,323,567,156,567,323,0.06689190864562988
482,242,153,164,0,0.4660000205039978,482.5,324,406,242.0,406,160,406,324,559,160,559,324,0.06681203842163086
475,247,149,171,0,0.46300002932548523,475.5,333,401,247.5,401,162,401,333,550,162,550,333,0.06673240661621094
469,248,148,168,0,0.46700000762939453,469.0,332,395,248.0,395,164,395,332,543,164,543,332,0.06645345687866211
461,250,144,166,0,0.46800002455711365,461.0,333,389,250.0,389,167,389,333,533,167,533,333,0.06699156761169434
453,251,142,161,0,0.4710000157356262,453.0,332,382,251.5,382,171,382,332,524,171,524,332,0.06628870964050293
445,252,138,157,0,0.47600001096725464,445.0,331,376,252.5,376,174,376,331,514,174,514,331,0.0673370361328125
436,254,134,154,0,0.4780000150203705,436.0,331,369,254.0,369,177,369,331,503,177,503,331,0.06601309776306152
427,257,131,154,0,0.4780000150203705,427.5,334,362,257.0,362,180,362,334,493,180,493,334,0.06599068641662598
418,258,130,151,0,0.4820000231266022,418.0,334,353,258.5,353,183,353,334,483,183,483,334,0.06637287139892578
408,261,124,152,0,0.4830000102519989,408.0,337,346,261.0,346,185,346,337,470,185,470,337,0.06785702705383301
399,262,122,147,0,0.4870000183582306,399.0,336,338,262.5,338,189,338,336,460,189,460,336,0.06608295440673828
389,264,120,145,0,0.4880000352859497,389.0,337,329,264.5,329,192,329,337,449,192,449,337,0.0670020580291748
379,265,116,142,0,0.0,379.0,336,321,265.0,321,194,321,336,437,194,437,336,0.06662821769714355
368,266,113,140,0,0.0,368.5,336,312,266.0,312,196,312,336,425,196,425,336,0.06567835807800293
357,267,109,137,0,0.0,357.5,336,303,267.5,303,199,303,336,412,199,412,336,0.06706976890563965
346,268,108,134,0,0.0,346.0,335,292,268.0,292,201,292,335,400,201,400,335,0.06668281555175781
335,269,106,133,0,0.0,335.0,336,282,269.5,282,203,282,336,388,203,388,336,0.06645703315734863
323,269,104,131,0,0.4350000321865082,323.0,335,271,269.5,271,204,271,335,375,204,375,335,0.06733918190002441
311,270,102,130,0,0.4440000355243683,311.0,335,260,270.0,260,205,260,335,362,205,362,335,0.06669068336486816
299,269,101,128,0,0.44700002670288086,299.5,333,249,269.0,249,205,249,333,350,205,350,333,0.06522822380065918
289,268,100,125,0,0.45600003004074097,289.0,331,239,268.5,239,206,239,331,339,206,339,331,0.06687283515930176
279,268,98,124,0,0.4610000252723694,279.0,330,230,268.0,230,206,230,330,328,206,328,330,0.06638813018798828
268,267,97,123,0,0.4710000157356262,268.5,329,220,267.5,220,206,220,329,317,206,317,329,0.06789422035217285
259,267,95,124,0,0.47700002789497375,259.5,329,212,267.0,212,205,212,329,307,205,307,329,0.06512022018432617
251,265,94,120,0,0.484000027179718,251.0,325,204,265.0,204,205,204,325,298,205,298,325,0.06592035293579102
243,263,94,118,0,0.492000013589859,243.0,322,196,263.0,196,204,196,322,290,204,290,322,0.06769657135009766
235,261,92,117,0,0.0,235.0,320,189,261.5,189,203,189,320,281,203,281,320,0.0656282901763916
228,260,92,117,0,0.534000039100647,228.0,319,182,260.5,182,202,182,319,274,202,274,319,0.06735444068908691
221,259,91,117,0,0.5700000524520874,221.5,318,176,259.5,176,201,176,318,267,201,267,318,0.06602597236633301
214,256,91,115,0,0.5580000281333923,214.5,314,169,256.5,169,199,169,314,260,199,260,314,0.0663752555847168
209,255,90,115,0,0.5720000267028809,209.0,313,164,255.5,164,198,164,313,254,198,254,313,0.06725621223449707
203,255,89,116,0,0.5750000476837158,203.5,313,159,255.0,159,197,159,313,248,197,248,313,0.06619119644165039
198,253,89,114,0,0.5820000171661377,198.5,310,154,253.0,154,196,154,310,243,196,243,310,0.06674456596374512
193,251,89,113,0,0.5870000123977661,193.5,308,149,251.5,149,195,149,308,238,195,238,308,0.06708168983459473
189,251,88,116,0,0.5910000205039978,189.0,309,145,251.0,145,193,145,309,233,193,233,309,0.06637883186340332
185,250,88,115,0,0.5950000286102295,185.0,308,141,250.5,141,193,141,308,229,193,229,308,0.06693339347839355
181,247,88,112,0,0.6000000238418579,181.0,303,137,247.0,137,191,137,303,225,191,225,303,0.06612706184387207
177,248,87,116,0,0.5950000286102295,177.5,306,134,248.0,134,190,134,306,221,190,221,306,0.06700301170349121
174,246,87,115,0,0.6010000109672546,174.5,304,131,246.5,131,189,131,304,218,189,218,304,0.06686806678771973
171,249,87,122,0,0.6020000576972961,171.5,310,128,249.0,128,188,128,310,215,188,215,310,0.0665888786315918
169,248,86,121,0,0.6070000529289246,169.0,309,126,248.5,126,188,126,309,212,188,212,309,0.06638026237487793
166,244,87,114,0,0.612000048160553,166.5,301,123,244.0,123,187,123,301,210,187,210,301,0.06620287895202637
164,241,87,111,0,0.612000048160553,164.5,297,121,241.5,121,186,121,297,208,186,208,297,0.06709837913513184
163,241,86,113,0,0.6080000400543213,163.0,298,120,241.5,120,185,120,298,206,185,206,298,0.06656980514526367
161,241,87,112,0,0.6130000352859497,161.5,297,118,241.0,118,185,118,297,205,185,205,297,0.06670284271240234
161,240,86,112,0,0.609000027179718,161.0,296,118,240.0,118,184,118,296,204,184,204,296,0.06651782989501953
160,240,86,112,0,0.6150000095367432,160.0,296,117,240.0,117,184,117,296,203,184,203,296,0.06603455543518066
159,238,87,109,0,0.6170000433921814,159.5,293,116,238.5,116,184,116,293,203,184,203,293,0.0669095516204834
159,239,87,110,0,0.6060000061988831,159.5,294,116,239.0,116,184,116,294,203,184,203,294,0.06665182113647461
160,239,86,110,0,0.6210000514984131,160.0,294,117,239.0,117,184,117,294,203,184,203,294,0.06635022163391113
160,239,86,110,0,0.6130000352859497,160.0,294,117,239.0,117,184,117,294,203,184,203,294,0.06693553924560547
161,238,86,109,0,0.6130000352859497,161.0,293,118,238.5,118,184,118,293,204,184,204,293,0.06745791435241699
162,238,87,109,0,0.6160000562667847,162.5,293,119,238.5,119,184,119,293,206,184,206,293,0.0664205551147461
164,238,86,108,0,0.6160000562667847,164.0,292,121,238.0,121,184,121,292,207,184,207,292,0.06602978706359863
166,238,86,109,0,0.6130000352859497,166.0,293,123,238.5,123,184,123,293,209,184,209,293,0.0660402774810791
169,241,86,112,0,0.6180000305175781,169.0,297,126,241.0,126,185,126,297,212,185,212,297,0.06710553169250488
172,242,86,114,0,0.6110000014305115,172.0,299,129,242.0,129,185,129,299,215,185,215,299,0.06598711013793945
176,242,86,115,0,0.6110000014305115,176.0,300,133,242.5,133,185,133,300,219,185,219,300,0.06699037551879883
180,241,86,112,0,0.6110000014305115,180.0,297,137,241.0,137,185,137,297,223,185,223,297,0.06670904159545898
184,242,86,113,0,0.609000027179718,184.0,299,141,242.5,141,186,141,299,227,186,227,299,0.0661783218383789
189,245,87,118,0,0.6080000400543213,189.5,304,146,245.0,146,186,146,304,233,186,233,304,0.06733441352844238
195,243,87,114,0,0.6080000400543213,195.5,300,152,243.0,152,186,152,300,239,186,239,300,0.0656130313873291
201,243,86,113,0,0.5990000367164612,201.0,300,158,243.5,158,187,158,300,244,187,244,300,0.06745696067810059
207,245,87,117,0,0.5960000157356262,207.5,304,164,245.5,164,187,164,304,251,187,251,304,0.06645703315734863
215,242,87,113,0,0.5960000157356262,215.5,299,172,242.5,172,186,172,299,259,186,259,299,0.06716609001159668
222,246,87,118,0,0.5920000076293945,222.5,305,179,246.0,179,187,179,305,266,187,266,305,0.06640267372131348
230,244,87,114,0,0.0,230.5,301,187,244.0,187,187,187,301,274,187,274,301,0.06642985343933105
239,245,87,116,0,0.5490000247955322,239.5,303,196,245.0,196,187,196,303,283,187,283,303,0.06676459312438965
248,243,87,114,0,0.5410000085830688,248.5,300,205,243.0,205,186,205,300,292,186,292,300,0.06634068489074707
258,243,88,112,0,0.0,258.0,299,214,243.0,214,187,214,299,302,187,302,299,0.06647133827209473
268,243,87,114,0,0.5440000295639038,268.5,300,225,243.0,225,186,225,300,312,186,312,300,0.06661868095397949
279,242,87,113,0,0.5760000348091125,279.5,299,236,242.5,236,186,236,299,323,186,323,299,0.06706857681274414
291,243,88,114,0,0.0,291.0,300,247,243.0,247,186,247,300,335,186,335,300,0.06629323959350586
304,241,88,113,0,0.0,304.0,298,260,241.5,260,185,260,298,348,185,348,298,0.06667208671569824
317,241,89,113,0,0.5060000419616699,317.5,298,273,241.5,273,185,273,298,362,185,362,298,0.06789493560791016
329,240,89,114,0,0.0,329.5,297,285,240.0,285,183,285,297,374,183,374,297,0.06557607650756836
342,240,89,116,0,0.0,342.5,298,298,240.0,298,182,298,298,387,182,387,298,0.0667717456817627
354,238,90,114,0,0.0,354.0,295,309,238.0,309,181,309,295,399,181,399,295,0.06596660614013672
366,237,90,117,0,0.6170000433921814,366.0,296,321,237.5,321,179,321,296,411,179,411,296,0.06714224815368652
378,236,92,116,0,0.6240000128746033,378.0,294,332,236.0,332,178,332,294,424,178,424,294,0.06743431091308594
388,234,94,115,0,0.6340000033378601,388.0,292,341,234.5,341,177,341,292,435,177,435,292,0.06513333320617676
397,233,95,115,0,0.6310000419616699,397.5,291,350,233.5,350,176,350,291,445,176,445,291,0.06703305244445801
407,232,96,116,0,0.6310000419616699,407.0,290,359,232.0,359,174,359,290,455,174,455,290,0.06618285179138184
416,231,97,117,0,0.6320000290870667,416.5,290,368,231.5,368,173,368,290,465,173,465,290,0.06668853759765625
424,230,99,116,0,0.6380000114440918,424.5,288,375,230.0,375,172,375,288,474,172,474,288,0.06669926643371582
433,228,99,117,0,0.6380000114440918,433.5,287,384,228.5,384,170,384,287,483,170,483,287,0.06665325164794922
440,228,102,118,0,0.6360000371932983,440.0,287,389,228.0,389,169,389,287,491,169,491,287,0.06679320335388184
447,228,103,121,0,0.6380000114440918,447.5,289,396,228.5,396,168,396,289,499,168,499,289,0.06598567962646484
454,225,104,118,0,0.6450000405311584,454.0,284,402,225.0,402,166,402,284,506,166,506,284,0.06718277931213379
460,226,104,122,0,0.6370000243186951,460.0,287,408,226.0,408,165,408,287,512,165,512,287,0.06614232063293457
466,226,105,125,0,0.6470000147819519,466.5,289,414,226.5,414,164,414,289,519,164,519,289,0.06657576560974121
471,225,105,124,0,0.6450000405311584,471.5,287,419,225.0,419,163,419,287,524,163,524,287,0.0669107437133789
476,224,106,124,0,0.6530000567436218,476.0,286,423,224.0,423,162,423,286,529,162,529,286,0.06632781028747559
480,223,106,125,0,0.6490000486373901,480.0,286,427,223.5,427,161,427,286,533,161,533,286,0.06707191467285156
483,222,108,124,0,0.6550000309944153,483.0,284,429,222.0,429,160,429,284,537,160,537,284,0.06630516052246094
486,221,108,125,0,0.6600000262260437,486.0,284,432,221.5,432,159,432,284,540,159,540,284,0.06692385673522949
488,222,109,126,0,0.6480000019073486,488.5,285,434,222.0,434,159,434,285,543,159,543,285,0.06663751602172852
490,220,109,124,0,0.6530000567436218,490.5,282,436,220.0,436,158,436,282,545,158,545,282,0.06616973876953125
492,219,108,122,0,0.6600000262260437,492.0,280,438,219.0,438,158,438,280,546,158,546,280,0.06731677055358887
493,219,108,124,0,0.6700000166893005,493.0,281,439,219.0,439,157,439,281,547,157,547,281,0.06684684753417969
493,218,108,122,0,0.6640000343322754,493.0,279,439,218.0,439,157,439,279,547,157,547,279,0.06615328788757324
493,219,108,122,0,0.6630000472068787,493.0,280,439,219.0,439,158,439,280,547,158,547,280,0.06659507751464844
493,219,108,122,0,0.6570000052452087,493.0,280,439,219.0,439,158,439,280,547,158,547,280,0.06638956069946289
493,220,108,124,0,0.6570000052452087,493.0,282,439,220.0,439,158,439,282,547,158,547,282,0.06665420532226562
492,219,108,123,0,0.6550000309944153,492.0,281,438,219.5,438,158,438,281,546,158,546,281,0.06708526611328125
491,220,109,124,0,0.6500000357627869,491.5,282,437,220.0,437,158,437,282,546,158,546,282,0.06597638130187988
490,219,109,123,0,0.6530000567436218,490.5,281,436,219.5,436,158,436,281,545,158,545,281,0.06812882423400879
489,222,109,127,0,0.6530000567436218,489.5,286,435,222.5,435,159,435,286,544,159,544,286,0.06483268737792969
488,223,109,129,0,0.64000004529953,488.5,288,434,223.5,434,159,434,288,543,159,543,288,0.06695365905761719
487,223,110,126,0,0.6440000534057617,487.0,286,432,223.0,432,160,432,286,542,160,542,286,0.0672597885131836
486,223,110,128,0,0.64000004529953,486.0,287,431,223.0,431,159,431,287,541,159,541,287,0.06566047668457031
484,224,110,129,0,0.6380000114440918,484.0,289,429,224.5,429,160,429,289,539,160,539,289,0.06749868392944336
482,226,110,131,0,0.64000004529953,482.0,292,427,226.5,427,161,427,292,537,161,537,292,0.0659799575805664
480,227,111,131,0,0.6270000338554382,480.5,293,425,227.5,425,162,425,293,536,162,536,293,0.06655240058898926
478,230,111,136,0,0.6290000081062317,478.5,298,423,230.0,423,162,423,298,534,162,534,298,0.0677938461303711
475,230,111,134,0,0.6180000305175781,475.5,297,420,230.0,420,163,420,297,531,163,531,297,0.06617307662963867
473,230,110,132,0,0.6190000176429749,473.0,296,418,230.0,418,164,418,296,528,164,528,296,0.06659269332885742
470,234,111,134,0,0.6110000014305115,470.5,301,415,234.0,415,167,415,301,526,167,526,301,0.06578636169433594
466,233,111,132,0,0.6100000143051147,466.5,299,411,233.0,411,167,411,299,522,167,522,299,0.0678853988647461
463,233,111,128,0,0.6060000061988831,463.5,297,408,233.0,408,169,408,297,519,169,519,297,0.06594991683959961
459,235,111,131,0,0.6050000190734863,459.5,301,404,235.5,404,170,404,301,515,170,515,301,0.06557965278625488
456,237,111,129,0,0.6020000576972961,456.5,302,401,237.5,401,173,401,302,512,173,512,302,0.06722545623779297
451,238,111,126,0,0.5940000414848328,451.5,301,396,238.0,396,175,396,301,507,175,507,301,0.06654977798461914
447,240,111,127,0,0.5879999995231628,447.5,304,392,240.5,392,177,392,304,503,177,503,304,0.06668519973754883
442,243,109,126,0,0.5820000171661377,442.5,306,388,243.0,388,180,388,306,497,180,497,306,0.0678248405456543
437,246,111,126,0,0.5730000138282776,437.5,309,382,246.0,382,183,382,309,493,183,493,309,0.06510591506958008
431,250,111,128,0,0.5649999976158142,431.5,314,376,250.0,376,186,376,314,487,186,487,314,0.1020655632019043
422,255,110,128,0,0.5600000023841858,422.0,319,367,255.0,367,191,367,319,477,191,477,319,0.0646975040435791
415,259,110,128,0,0.5509999990463257,415.0,323,360,259.0,360,195,360,323,470,195,470,323,0.06656503677368164
408,266,110,132,0,0.5390000343322754,408.0,332,353,266.0,353,200,353,332,463,200,463,332,0.06666731834411621
400,269,109,132,0,0.5320000052452087,400.5,335,346,269.0,346,203,346,335,455,203,455,335,0.06655430793762207
393,273,108,130,0,0.5260000228881836,393.0,338,339,273.0,339,208,339,338,447,208,447,338,0.06735968589782715
386,278,108,132,0,0.5020000338554382,386.0,344,332,278.0,332,212,332,344,440,212,440,344,0.06603550910949707
378,282,108,131,0,0.49900001287460327,378.0,348,324,282.5,324,217,324,348,432,217,432,348,0.0666661262512207
371,287,108,132,0,0.492000013589859,371.0,353,317,287.0,317,221,317,353,425,221,425,353,0.06623244285583496
363,291,107,133,0,0.48000001907348633,363.5,358,310,291.5,310,225,310,358,417,225,417,358,0.06648945808410645
356,295,107,133,0,0.484000027179718,356.5,362,303,295.5,303,229,303,362,410,229,410,362,0.06653928756713867
349,300,107,132,0,0.48500001430511475,349.5,366,296,300.0,296,234,296,366,403,234,403,366,0.06620192527770996
341,303,107,133,0,0.4820000231266022,341.5,370,288,303.5,288,237,288,370,395,237,395,370,0.06707334518432617
335,307,108,133,0,0.4780000150203705,335.0,374,281,307.5,281,241,281,374,389,241,389,374,0.06646418571472168
327,311,108,136,0,0.4750000238418579,327.0,379,273,311.0,273,243,273,379,381,243,381,379,0.06644654273986816
321,314,108,135,0,0.47200003266334534,321.0,382,267,314.5,267,247,267,382,375,247,375,382,0.06668829917907715
314,318,107,134,0,0.4710000157356262,314.5,385,261,318.0,261,251,261,385,368,251,368,385,0.0662541389465332
308,322,109,135,0,0.46000000834465027,308.5,390,254,322.5,254,255,254,390,363,255,363,390,0.06723856925964355
302,324,109,135,0,0.44700002670288086,302.5,392,248,324.5,248,257,248,392,357,257,357,392,0.06680154800415039
297,326,109,135,0,0.4410000145435333,297.5,394,243,326.5,243,259,243,394,352,259,352,394,0.06578540802001953
292,329,110,135,0,0.4440000355243683,292.0,397,237,329.5,237,262,237,397,347,262,347,397,0.06709837913513184
287,332,111,135,0,0.44300001859664917,287.5,400,232,332.5,232,265,232,400,343,265,343,400,0.06700921058654785
283,334,110,134,0,0.445000022649765,283.0,401,228,334.0,228,267,228,401,338,267,338,401,0.06628632545471191
279,336,111,135,0,0.4400000274181366,279.5,404,224,336.5,224,269,224,404,335,269,335,404,0.06716251373291016
275,338,112,137,0,0.4440000355243683,275.0,407,219,338.5,219,270,219,407,331,270,331,407,0.06634640693664551
272,340,111,136,0,0.44200003147125244,272.5,408,217,340.0,217,272,217,408,328,272,328,408,0.06671833992004395
269,341,111,137,0,0.44300001859664917,269.5,410,214,341.5,214,273,214,410,325,273,325,410,0.06663632392883301
267,342,112,137,0,0.4440000355243683,267.0,411,211,342.5,211,274,211,411,323,274,323,411,0.06582784652709961
265,343,112,139,0,0.44300001859664917,265.0,413,209,343.5,209,274,209,413,321,274,321,413,0.06717061996459961
263,344,111,138,0,0.445000022649765,263.5,413,208,344.0,208,275,208,413,319,275,319,413,0.06687736511230469
262,344,112,138,0,0.445000022649765,262.0,413,206,344.0,206,275,206,413,318,275,318,413,0.06628632545471191
261,345,111,138,0,0.44600000977516174,261.5,414,206,345.0,206,276,206,414,317,276,317,414,0.06701278686523438
262,345,112,138,0,0.445000022649765,262.0,414,206,345.0,206,276,206,414,318,276,318,414,0.06676244735717773
262,344,112,139,0,0.4440000355243683,262.0,414,206,344.5,206,275,206,414,318,275,318,414,0.06617212295532227
261,343,113,137,0,0.44300001859664917,261.5,412,205,343.5,205,275,205,412,318,275,318,412,0.06662321090698242
262,343,112,138,0,0.4410000145435333,262.0,412,206,343.0,206,274,206,412,318,274,318,412,0.0665898323059082
262,343,113,138,0,0.4410000145435333,262.5,412,206,343.0,206,274,206,412,319,274,319,412,0.06669235229492188
262,342,113,139,0,0.4390000104904175,262.5,412,206,342.5,206,273,206,412,319,273,319,412,0.0660104751586914
263,342,115,138,0,0.4360000193119049,263.5,411,206,342.0,206,273,206,411,321,273,321,411,0.06843876838684082
264,340,114,139,0,0.4320000112056732,264.0,410,207,340.5,207,271,207,410,321,271,321,410,0.06519770622253418
264,340,115,141,0,0.0,264.5,411,207,340.5,207,270,207,411,322,270,322,411,0.06681585311889648
265,339,114,142,0,0.4300000071525574,265.0,410,208,339.0,208,268,208,410,322,268,322,410,0.06592893600463867
265,337,115,142,0,0.42500001192092896,265.5,408,208,337.0,208,266,208,408,323,266,323,408,0.0670924186706543
266,335,116,143,0,0.4180000126361847,266.0,407,208,335.5,208,264,208,407,324,264,324,407,0.06645011901855469
267,335,117,149,0,0.41700002551078796,267.5,410,209,335.5,209,261,209,410,326,261,326,410,0.06606411933898926
268,332,118,149,0,0.40700000524520874,268.0,407,209,332.5,209,258,209,407,327,258,327,407,0.0672299861907959
269,330,119,148,0,0.406000018119812,269.5,404,210,330.0,210,256,210,404,329,256,329,404,0.06692957878112793
270,326,120,148,0,0.3960000276565552,270.0,400,210,326.0,210,252,210,400,330,252,330,400,0.06618547439575195
270,322,121,149,0,0.3850000202655792,270.5,397,210,322.5,210,248,210,397,331,248,331,397,0.0669701099395752
271,319,123,151,0,0.3790000081062317,271.5,395,210,319.5,210,244,210,395,333,244,333,395,0.0662684440612793
273,316,124,152,0,0.37300002574920654,273.0,392,211,316.0,211,240,211,392,335,240,335,392,0.06689643859863281
273,316,125,160,0,0.37400001287460327,273.5,396,211,316.0,211,236,211,396,336,236,336,396,0.06699609756469727
274,308,126,156,0,0.3620000183582306,274.0,386,211,308.0,211,230,211,386,337,230,337,386,0.06602025032043457
275,303,127,159,0,0.34800001978874207,275.5,383,212,303.5,212,224,212,383,339,224,339,383,0.06706881523132324
276,299,129,160,0,0.3440000116825104,276.5,379,212,299.0,212,219,212,379,341,219,341,379,0.06677532196044922
277,294,132,164,0,0.3330000042915344,277.0,376,211,294.0,211,212,211,376,343,212,343,376,0.0662989616394043
277,288,133,164,0,0.3240000009536743,277.5,370,211,288.0,211,206,211,370,344,206,344,370,0.06700682640075684
278,284,134,168,0,0.32200002670288086,278.0,368,211,284.0,211,200,211,368,345,200,345,368,0.06571745872497559
278,279,135,170,0,0.0,278.5,364,211,279.0,211,194,211,364,346,194,346,364,0.06753277778625488
278,275,137,172,0,0.0,278.5,361,210,275.0,210,189,210,361,347,189,347,361,0.06667208671569824
279,269,138,171,0,0.0,279.0,355,210,269.5,210,184,210,355,348,184,348,355,0.06595730781555176
279,265,140,174,0,0.0,279.0,352,209,265.0,209,178,209,352,349,178,349,352,0.06887102127075195
279,260,141,175,0,0.38200002908706665,279.5,348,209,260.5,209,173,209,348,350,173,350,348,0.0643317699432373
279,257,141,178,0,0.0,279.5,346,209,257.0,209,168,209,346,350,168,350,346,0.06731438636779785
279,253,143,178,0,0.0,279.5,342,208,253.0,208,164,208,342,351,164,351,342,0.06611394882202148
279,249,145,179,0,0.0,279.5,339,207,249.5,207,160,207,339,352,160,352,339,0.06627655029296875
279,246,146,181,0,0.0,279.0,337,206,246.5,206,156,206,337,352,156,352,337,0.06752777099609375
279,244,146,183,0,0.0,279.0,336,206,244.5,206,153,206,336,352,153,352,336,0.06582188606262207
278,241,147,184,0,0.36000001430511475,278.5,333,205,241.0,205,149,205,333,352,149,352,333,0.06644392013549805
278,238,149,184,0,0.0,278.5,330,204,238.0,204,146,204,330,353,146,353,330,0.06694865226745605
278,237,149,185,0,0.0,278.5,330,204,237.5,204,145,204,330,353,145,353,330,0.06609964370727539
278,235,149,185,0,0.0,278.5,328,204,235.5,204,143,204,328,353,143,353,328,0.06699848175048828
278,234,149,186,0,0.3500000238418579,278.5,327,204,234.0,204,141,204,327,353,141,353,327,0.06604981422424316
278,233,149,186,0,0.3490000069141388,278.5,326,204,233.0,204,140,204,326,353,140,353,326,0.0670461654663086
279,232,150,187,0,0.35600000619888306,279.0,326,204,232.5,204,139,204,326,354,139,354,326,0.06681203842163086
279,232,150,187,0,0.35100001096725464,279.0,326,204,232.5,204,139,204,326,354,139,354,326,0.06604385375976562
278,232,149,186,0,0.35200002789497375,278.5,325,204,232.0,204,139,204,325,353,139,353,325,0.06728243827819824
278,232,149,186,0,0.35100001096725464,278.5,325,204,232.0,204,139,204,325,353,139,353,325,0.06655335426330566
277,232,150,187,0,0.35500001907348633,277.0,326,202,232.5,202,139,202,326,352,139,352,326,0.06677532196044922
275,232,150,188,0,0.0,275.0,326,200,232.0,200,138,200,326,350,138,350,326,0.06654644012451172
272,232,151,188,0,0.33400002121925354,272.5,326,197,232.0,197,138,197,326,348,138,348,326,0.06608200073242188
269,234,151,192,0,0.33400002121925354,269.5,330,194,234.0,194,138,194,330,345,138,345,330,0.06738114356994629
265,234,152,190,0,0.34300002455711365,265.0,329,189,234.0,189,139,189,329,341,139,341,329,0.06627321243286133
260,233,153,191,0,0.33400002121925354,260.5,329,184,233.5,184,138,184,329,337,138,337,329,0.0660548210144043
255,234,153,188,0,0.33100003004074097,255.5,328,179,234.0,179,140,179,328,332,140,332,328,0.06710433959960938
249,234,154,190,0,0.33800002932548523,249.0,329,172,234.0,172,139,172,329,326,139,326,329,0.0666658878326416
242,235,155,189,0,0.0,242.5,330,165,235.5,165,141,165,330,320,141,320,330,0.06714224815368652
235,236,156,190,0,0.0,235.0,331,157,236.0,157,141,157,331,313,141,313,331,0.0662992000579834
227,238,158,194,0,0.0,227.0,335,148,238.0,148,141,148,335,306,141,306,335,0.0666506290435791
217,238,158,192,0,0.0,217.0,334,138,238.0,138,142,138,334,296,142,296,334,0.06615328788757324
207,239,161,194,0,0.0,207.5,336,127,239.0,127,142,127,336,288,142,288,336,0.06602358818054199
197,239,162,193,0,0.0,197.0,336,116,239.5,116,143,116,336,278,143,278,336,0.06698083877563477
186,241,163,195,0,0.0,186.5,339,105,241.5,105,144,105,339,268,144,268,339,0.0676729679107666
176,241,164,195,0,0.0,176.0,339,94,241.5,94,144,94,339,258,144,258,339,0.06600332260131836
165,242,165,196,0,0.0,165.5,340,83,242.0,83,144,83,340,248,144,248,340,0.06655597686767578
157,243,166,196,0,0.0,157.0,341,74,243.0,74,145,74,341,240,145,240,341,0.06655097007751465
148,244,167,198,0,0.0,148.5,343,65,244.0,65,145,65,343,232,145,232,343,0.06641697883605957
140,244,167,196,0,0.0,140.5,342,57,244.0,57,146,57,342,224,146,224,342,0.0672597885131836
134,244,168,197,0,0.0,134.0,343,50,244.5,50,146,50,343,218,146,218,343,0.06658792495727539
128,245,170,198,0,0.0,128.0,344,43,245.0,43,146,43,344,213,146,213,344,0.06682276725769043
123,246,170,198,0,0.0,123.0,345,38,246.0,38,147,38,345,208,147,208,345,0.06616902351379395
117,247,171,201,0,0.0,117.5,348,32,247.5,32,147,32,348,203,147,203,348,0.06632280349731445
114,248,171,202,0,0.0,114.5,349,29,248.0,29,147,29,349,200,147,200,349,0.06698775291442871
111,247,170,200,0,0.0,111.0,347,26,247.0,26,147,26,347,196,147,196,347,0.0680696964263916
108,247,171,200,0,0.3500000238418579,108.5,347,23,247.0,23,147,23,347,194,147,194,347,0.06504654884338379
106,247,171,199,0,0.0,106.5,347,21,247.5,21,148,21,347,192,148,192,347,0.06641435623168945
106,249,171,202,0,0.0,106.5,350,21,249.0,21,148,21,350,192,148,192,350,0.06681942939758301
106,247,171,199,0,0.0,106.5,347,21,247.5,21,148,21,347,192,148,192,347,0.06726574897766113
107,248,172,202,0,0.3440000116825104,107.0,349,21,248.0,21,147,21,349,193,147,193,349,0.06511926651000977
108,248,172,201,0,0.0,108.0,349,22,248.5,22,148,22,349,194,148,194,349,0.06694626808166504
110,255,171,209,0,0.0,110.5,360,25,255.5,25,151,25,360,196,151,196,360,0.06708407402038574
113,254,172,205,0,0.0,113.0,357,27,254.5,27,152,27,357,199,152,199,357,0.06637740135192871
116,263,172,219,0,0.0,116.0,373,30,263.5,30,154,30,373,202,154,202,373,0.06650829315185547
120,266,172,221,0,0.3410000205039978,120.0,377,34,266.5,34,156,34,377,206,156,206,377,0.09893941879272461
128,268,172,217,0,0.0,128.0,377,42,268.5,42,160,42,377,214,160,214,377,0.08034157752990723
134,269,172,210,0,0.0,134.0,374,48,269.0,48,164,48,374,220,164,220,374,0.06419515609741211
140,269,173,203,0,0.0,140.5,371,54,269.5,54,168,54,371,227,168,227,371,0.06249403953552246
148,273,172,206,0,0.0,148.0,376,62,273.0,62,170,62,376,234,170,234,376,0.06334280967712402
157,276,174,202,0,0.0,157.0,377,70,276.0,70,175,70,377,244,175,244,377,0.06362438201904297
166,281,173,201,0,0.2550000250339508,166.5,382,80,281.5,80,181,80,382,253,181,253,382,0.06709933280944824
177,286,174,203,0,0.2540000081062317,177.0,388,90,286.5,90,185,90,388,264,185,264,388,0.06604623794555664
188,292,175,204,0,0.25200000405311584,188.5,394,101,292.0,101,190,101,394,276,190,276,394,0.06690573692321777
201,298,176,204,0,0.2510000169277191,201.0,400,113,298.0,113,196,113,400,289,196,289,400,0.06755661964416504
215,304,176,205,0,0.24900001287460327,215.0,407,127,304.5,127,202,127,407,303,202,303,407,0.06612014770507812
230,311,179,207,0,0.2460000067949295,230.5,415,141,311.5,141,208,141,415,320,208,320,415,0.06598305702209473
246,318,179,210,0,0.0,246.5,423,157,318.0,157,213,157,423,336,213,336,423,0.06676840782165527
264,324,179,209,0,0.0,264.5,429,175,324.5,175,220,175,429,354,220,354,429,0.06680512428283691
283,332,183,210,0,0.0,283.5,437,192,332.0,192,227,192,437,375,227,375,437,0.06676578521728516
303,339,182,212,0,0.0,303.0,445,212,339.0,212,233,212,445,394,233,394,445,0.06627058982849121
321,345,184,212,0,0.0,321.0,451,229,345.0,229,239,229,451,413,239,413,451,0.06833910942077637
339,351,185,213,0,0.3140000104904175,339.5,458,247,351.5,247,245,247,458,432,245,432,458,0.06602859497070312
357,358,187,216,0,0.3100000023841858,357.5,466,264,358.0,264,250,264,466,451,250,451,466,0.06520938873291016
375,363,189,218,0,0.3100000023841858,375.5,472,281,363.0,281,254,281,472,470,254,470,472,0.06684756278991699
391,367,191,217,0,0.3100000023841858,391.5,476,296,367.5,296,259,296,476,487,259,487,476,0.06680989265441895
406,371,195,216,0,0.30900001525878906,406.5,479,309,371.0,309,263,309,479,504,263,504,479,0.06679558753967285
419,373,196,214,0,0.30800002813339233,419.0,480,321,373.0,321,266,321,480,517,266,517,480,0.0659325122833252
431,375,201,210,0,0.30900001525878906,431.5,480,331,375.0,331,270,331,480,532,270,532,480,0.06635046005249023
442,376,205,208,0,0.30800002813339233,442.5,480,340,376.0,340,272,340,480,545,272,545,480,0.06694650650024414
452,377,209,205,0,0.30800002813339233,452.5,480,348,377.5,348,275,348,480,557,275,557,480,0.06626486778259277
462,378,212,201,0,0.30800002813339233,462.0,479,356,378.5,356,278,356,479,568,278,568,479,0.06747603416442871
471,379,215,199,0,0.30800002813339233,471.5,479,364,379.5,364,280,364,479,579,280,579,479,0.06608200073242188
478,380,217,198,0,0.30800002813339233,478.5,479,370,380.0,370,281,370,479,587,281,587,479,0.06684184074401855
485,380,220,197,0,0.3070000112056732,485.0,479,375,380.5,375,282,375,479,595,282,595,479,0.06697869300842285
489,381,222,195,0,0.3070000112056732,489.0,479,378,381.5,378,284,378,479,600,284,600,479,0.06608438491821289
494,382,223,194,0,0.3070000112056732,494.5,479,383,382.0,383,285,383,479,606,285,606,479,0.0664358139038086
498,382,225,194,0,0.3070000112056732,498.5,479,386,382.0,386,285,386,479,611,285,611,479,0.06704497337341309
500,382,227,193,0,0.3070000112056732,500.5,479,387,382.5,387,286,387,479,614,286,614,479,0.06644034385681152
501,383,227,192,0,0.3070000112056732,501.5,479,388,383.0,388,287,388,479,615,287,615,479,0.06695008277893066
500,383,227,192,0,0.3060000240802765,500.5,479,387,383.0,387,287,387,479,614,287,614,479,0.0659489631652832
500,382,228,193,0,0.3070000112056732,500.0,479,386,382.5,386,286,386,479,614,286,614,479,0.0679616928100586
499,382,226,193,0,0.30800002813339233,499.0,479,386,382.5,386,286,386,479,612,286,612,479,0.06617474555969238
497,381,224,195,0,0.3060000240802765,497.0,479,385,381.5,385,284,385,479,609,284,609,479,0.06591558456420898
492,381,223,195,0,0.3070000112056732,492.5,479,381,381.5,381,284,381,479,604,284,604,479,0.06694412231445312
488,380,221,197,0,0.3070000112056732,488.5,479,378,380.5,378,282,378,479,599,282,599,479,0.06655335426330566
484,379,220,199,0,0.3060000240802765,484.0,479,374,379.5,374,280,374,479,594,280,594,479,0.06646871566772461
479,378,218,201,0,0.3070000112056732,479.0,479,370,378.5,370,278,370,479,588,278,588,479,0.06690120697021484
472,377,216,204,0,0.30800002813339233,472.0,479,364,377.0,364,275,364,479,580,275,580,479,0.06631946563720703
465,375,214,207,0,0.3070000112056732,465.0,479,358,375.5,358,272,358,479,572,272,572,479,0.06682872772216797
457,374,212,210,0,0.3070000112056732,457.0,479,351,374.0,351,269,351,479,563,269,563,479,0.06593585014343262
448,372,209,213,0,0.3060000240802765,448.5,479,344,372.5,344,266,344,479,553,266,553,479,0.06682777404785156
439,370,206,218,0,0.3070000112056732,439.0,479,336,370.0,336,261,336,479,542,261,542,479,0.06647372245788574
428,367,203,220,0,0.3070000112056732,428.5,477,327,367.0,327,257,327,477,530,257,530,477,0.06629228591918945
417,363,199,222,0,0.3070000112056732,417.5,474,318,363.0,318,252,318,474,517,252,517,474,0.0673370361328125
407,357,196,221,0,0.30800002813339233,407.0,468,309,357.5,309,247,309,468,505,247,505,468,0.06729531288146973
395,350,194,218,0,0.3100000023841858,395.0,459,298,350.0,298,241,298,459,492,241,492,459,0.06598567962646484
381,343,191,219,0,0.31200000643730164,381.5,453,286,343.5,286,234,286,453,477,234,477,453,0.06594657897949219
367,337,187,217,0,0.31200000643730164,367.5,446,274,337.5,274,229,274,446,461,229,461,446,0.06682753562927246
353,330,186,217,0,0.3150000274181366,353.0,439,260,330.5,260,222,260,439,446,222,446,439,0.0666046142578125
337,322,185,215,0,0.0,337.5,430,245,322.5,245,215,245,430,430,215,430,430,0.06622076034545898
321,315,185,216,0,0.0,321.5,423,229,315.0,229,207,229,423,414,207,414,423,0.06672096252441406
306,307,186,215,0,0.2330000102519989,306.0,415,213,307.5,213,200,213,415,399,200,399,415,0.06657266616821289
292,299,185,214,0,0.0,292.5,406,200,299.0,200,192,200,406,385,192,385,406,0.06628751754760742
279,292,183,212,0,0.0,279.5,398,188,292.0,188,186,188,398,371,186,371,398,0.06705427169799805
267,285,182,212,0,0.0,267.0,391,176,285.0,176,179,176,391,358,179,358,391,0.06662583351135254
256,279,182,213,0,0.0,256.0,386,165,279.5,165,173,165,386,347,173,347,386,0.06707239151000977
245,272,181,213,0,0.0,245.5,379,155,272.5,155,166,155,379,336,166,336,379,0.06617927551269531
236,267,180,211,0,0.0,236.0,373,146,267.5,146,162,146,373,326,162,326,373,0.06749224662780762
227,263,180,214,0,0.0,227.0,370,137,263.0,137,156,137,370,317,156,317,370,0.06568312644958496
219,259,179,214,0,0.0,219.5,366,130,259.0,130,152,130,366,309,152,309,366,0.06725382804870605
211,253,179,213,0,0.0,211.5,360,122,253.5,122,147,122,360,301,147,301,360,0.06700801849365234
205,250,178,215,0,0.0,205.0,358,116,250.5,116,143,116,358,294,143,294,358,0.06664228439331055
199,245,178,212,0,0.0,199.0,351,110,245.0,110,139,110,351,288,139,288,351,0.06631851196289062
194,241,178,210,0,0.0,194.0,346,105,241.0,105,136,105,346,283,136,283,346,0.06601071357727051
189,240,179,215,0,0.0,189.5,348,100,240.5,100,133,100,348,279,133,279,348,0.0668027400970459
185,236,179,213,0,0.289000004529953,185.5,343,96,236.5,96,130,96,343,275,130,275,343,0.06617355346679688
182,234,179,212,0,0.2880000174045563,182.5,340,93,234.0,93,128,93,340,272,128,272,340,0.0670924186706543
179,233,178,214,0,0.29200002551078796,179.0,340,90,233.0,90,126,90,340,268,126,268,340,0.06736898422241211
177,231,178,213,0,0.2900000214576721,177.0,338,88,231.5,88,125,88,338,266,125,266,338,0.06525063514709473
176,230,178,215,0,0.29100000858306885,176.0,338,87,230.5,87,123,87,338,265,123,265,338,0.06726193428039551
175,230,179,215,0,0.29100000858306885,175.5,338,86,230.5,86,123,86,338,265,123,265,338,0.06650924682617188
175,230,179,215,0,0.2900000214576721,175.5,338,86,230.5,86,123,86,338,265,123,265,338,0.06618642807006836
175,230,179,215,0,0.29100000858306885,175.5,338,86,230.5,86,123,86,338,265,123,265,338,0.06665778160095215
175,231,179,215,0,0.2900000214576721,175.5,339,86,231.5,86,124,86,339,265,124,265,339,0.06640005111694336
176,232,178,215,0,0.2900000214576721,176.0,340,87,232.5,87,125,87,340,265,125,265,340,0.06682252883911133
176,233,177,212,0,0.289000004529953,176.5,339,88,233.0,88,127,88,339,265,127,265,339,0.06705188751220703
177,234,176,211,0,0.29200002551078796,177.0,340,89,234.5,89,129,89,340,265,129,265,340,0.06640124320983887
178,236,176,209,0,0.29600000381469727,178.0,341,90,236.5,90,132,90,341,266,132,266,341,0.06671833992004395
180,238,174,208,0,0.0,180.0,342,93,238.0,93,134,93,342,267,134,267,342,0.06676363945007324
181,241,174,208,0,0.0,181.0,345,94,241.0,94,137,94,345,268,137,268,345,0.06690478324890137
182,243,173,205,0,0.30300000309944153,182.5,346,96,243.5,96,141,96,346,269,141,269,346,0.0661780834197998
184,248,172,206,0,0.3060000240802765,184.0,351,98,248.0,98,145,98,351,270,145,270,351,0.06656980514526367
186,251,170,205,0,0.0,186.0,354,101,251.5,101,149,101,354,271,149,271,354,0.06626605987548828
187,265,169,223,0,0.2590000033378601,187.5,377,103,265.5,103,154,103,377,272,154,272,377,0.06683111190795898
189,263,168,206,0,0.0,189.0,366,105,263.0,105,160,105,366,273,160,273,366,0.06701159477233887
190,268,167,207,0,0.26500001549720764,190.5,372,107,268.5,107,165,107,372,274,165,274,372,0.06621980667114258
193,272,164,204,0,0.26500001549720764,193.0,374,111,272.0,111,170,111,374,275,170,275,374,0.06666970252990723
195,274,163,197,0,0.27000001072883606,195.5,373,114,274.5,114,176,114,373,277,176,277,373,0.06661176681518555
197,279,161,192,0,0.2750000059604645,197.5,375,117,279.0,117,183,117,375,278,183,278,375,0.06616592407226562
199,283,159,189,0,0.27400001883506775,199.5,378,120,283.5,120,189,120,378,279,189,279,378,0.06657958030700684
201,289,157,188,0,0.281000018119812,201.5,383,123,289.0,123,195,123,383,280,195,280,383,0.06668877601623535
203,293,155,184,0,0.0,203.5,385,126,293.0,126,201,126,385,281,201,281,385,0.06693696975708008
205,299,152,182,0,0.2970000207424164,205.0,390,129,299.0,129,208,129,390,281,208,281,390,0.06670069694519043
207,305,149,182,0,0.3100000023841858,207.5,396,133,305.0,133,214,133,396,282,214,282,396,0.06625628471374512
209,311,147,179,0,0.0,209.5,401,136,311.5,136,222,136,401,283,222,283,401,0.06702947616577148
210,315,145,176,0,0.0,210.5,403,138,315.0,138,227,138,403,283,227,283,403,0.06620907783508301
212,320,143,174,0,0.0,212.5,407,141,320.0,141,233,141,407,284,233,284,407,0.06638956069946289
214,323,140,170,0,0.0,214.0,408,144,323.0,144,238,144,408,284,238,284,408,0.06691789627075195
215,327,139,168,0,0.0,215.5,411,146,327.0,146,243,146,411,285,243,285,411,0.06681227684020996
216,330,137,165,0,0.0,216.5,413,148,330.5,148,248,148,413,285,248,285,413,0.06654620170593262
217,334,136,163,0,0.0,217.0,416,149,334.5,149,253,149,416,285,253,285,416,0.06653666496276855
217,336,135,161,0,0.3890000283718109,217.5,417,150,336.5,150,256,150,417,285,256,285,417,0.06661415100097656
218,338,133,158,0,0.3930000066757202,218.5,417,152,338.0,152,259,152,417,285,259,285,417,0.06689882278442383
219,340,132,157,0,0.3970000147819519,219.0,419,153,340.5,153,262,153,419,285,262,285,419,0.06613421440124512
219,342,131,157,0,0.398000031709671,219.5,421,154,342.5,154,264,154,421,285,264,285,421,0.06680750846862793
219,345,130,157,0,0.39900001883506775,219.0,424,154,345.5,154,267,154,424,284,267,284,424,0.06639552116394043
219,346,129,155,0,0.40300002694129944,219.5,424,155,346.5,155,269,155,424,284,269,284,424,0.06677412986755371
219,347,129,153,0,0.4050000309944153,219.5,424,155,347.5,155,271,155,424,284,271,284,424,0.06745195388793945
220,348,128,153,0,0.406000018119812,220.0,425,156,348.5,156,272,156,425,284,272,284,425,0.06536602973937988
220,349,128,153,0,0.40800002217292786,220.0,426,156,349.5,156,273,156,426,284,273,284,426,0.06670093536376953
220,350,127,151,0,0.4100000262260437,220.5,426,157,350.5,157,275,157,426,284,275,284,426,0.06649637222290039
220,351,127,150,0,0.4100000262260437,220.5,426,157,351.0,157,276,157,426,284,276,284,426,0.0666041374206543
220,352,127,150,0,0.41200003027915955,220.5,427,157,352.0,157,277,157,427,284,277,284,427,0.06678247451782227
221,352,126,150,0,0.41200003027915955,221.0,427,158,352.0,158,277,158,427,284,277,284,427,0.06598448753356934
221,352,126,149,0,0.4140000343322754,221.0,427,158,352.5,158,278,158,427,284,278,284,427,0.06722187995910645
221,352,126,149,0,0.4130000174045563,221.0,427,158,352.5,158,278,158,427,284,278,284,427,0.06643462181091309
221,352,126,149,0,0.4150000214576721,221.0,427,158,352.5,158,278,158,427,284,278,284,427,0.06653070449829102
221,352,125,149,0,0.41200003027915955,221.5,427,159,352.5,159,278,159,427,284,278,284,427,0.06658172607421875
223,353,124,149,0,0.4140000343322754,223.0,428,161,353.5,161,279,161,428,285,279,285,428,0.06787967681884766
224,353,125,149,0,0.4130000174045563,224.5,428,162,353.5,162,279,162,428,287,279,287,428,0.0657804012298584
227,354,125,150,0,0.4130000174045563,227.5,429,165,354.0,165,279,165,429,290,279,290,429,0.06625628471374512
229,354,125,151,0,0.4150000214576721,229.5,430,167,354.5,167,279,167,430,292,279,292,430,0.06660795211791992
234,354,124,149,0,0.4130000174045563,234.0,429,172,354.5,172,280,172,429,296,280,296,429,0.06811118125915527
238,354,123,148,0,0.41200003027915955,238.5,428,177,354.0,177,280,177,428,300,280,300,428,0.0653231143951416
243,355,123,148,0,0.4130000174045563,243.5,429,182,355.0,182,281,182,429,305,281,305,429,0.06625771522521973
250,354,124,147,0,0.41200003027915955,250.0,428,188,354.5,188,281,188,428,312,281,312,428,0.0676727294921875
257,356,124,148,0,0.4130000174045563,257.0,430,195,356.0,195,282,195,430,319,282,319,430,0.0658872127532959
264,356,125,148,0,0.41200003027915955,264.5,430,202,356.0,202,282,202,430,327,282,327,430,0.06637287139892578
272,356,123,148,0,0.4130000174045563,272.5,430,211,356.0,211,282,211,430,334,282,334,430,0.0671088695526123
281,356,122,147,0,0.4180000126361847,281.0,430,220,356.5,220,283,220,430,342,283,342,430,0.06612825393676758
290,357,123,148,0,0.4220000207424164,290.5,431,229,357.0,229,283,229,431,352,283,352,431,0.06684660911560059
301,357,123,147,0,0.42500001192092896,301.5,431,240,357.5,240,284,240,431,363,284,363,431,0.0663299560546875
312,357,121,145,0,0.4270000159740448,312.5,430,252,357.5,252,285,252,430,373,285,373,430,0.06687021255493164
325,358,122,146,0,0.4270000159740448,325.0,431,264,358.0,264,285,264,431,386,285,386,431,0.06673860549926758
337,358,122,146,0,0.4280000329017639,337.0,431,276,358.0,276,285,276,431,398,285,398,431,0.06680750846862793
349,359,122,146,0,0.4270000159740448,349.0,432,288,359.0,288,286,288,432,410,286,410,432,0.06664347648620605
361,359,123,144,0,0.4300000071525574,361.5,431,300,359.0,300,287,300,431,423,287,423,431,0.06659364700317383
373,358,122,144,0,0.4300000071525574,373.0,430,312,358.0,312,286,312,430,434,286,434,430,0.06601190567016602
383,359,124,144,0,0.43300002813339233,383.0,431,321,359.0,321,287,321,431,445,287,445,431,0.0675971508026123
392,359,126,144,0,0.43300002813339233,392.0,431,329,359.0,329,287,329,431,455,287,455,431,0.06624913215637207
401,359,127,144,0,0.43800002336502075,401.5,431,338,359.0,338,287,338,431,465,287,465,431,0.0662078857421875
408,359,127,143,0,0.4400000274181366,408.5,431,345,359.5,345,288,345,431,472,288,472,431,0.06637382507324219
416,360,128,144,0,0.44300001859664917,416.0,432,352,360.0,352,288,352,432,480,288,480,432,0.0667123794555664
422,360,129,145,0,0.445000022649765,422.5,433,358,360.5,358,288,358,433,487,288,487,433,0.06732487678527832
429,361,130,146,0,0.445000022649765,429.0,434,364,361.0,364,288,364,434,494,288,494,434,0.06647610664367676
434,361,130,146,0,0.44600000977516174,434.0,434,369,361.0,369,288,369,434,499,288,499,434,0.06717419624328613
438,360,131,144,0,0.45000001788139343,438.5,432,373,360.0,373,288,373,432,504,288,504,432,0.06647133827209473
443,360,132,144,0,0.45000001788139343,443.0,432,377,360.0,377,288,377,432,509,288,509,432,0.06606268882751465
446,359,132,143,0,0.4520000219345093,446.0,431,380,359.5,380,288,380,431,512,288,512,431,0.06769919395446777
448,359,132,142,0,0.45100003480911255,448.0,430,382,359.0,382,288,382,430,514,288,514,430,0.0659182071685791
450,359,133,142,0,0.4540000259876251,450.5,430,384,359.0,384,288,384,430,517,288,517,430,0.06707930564880371
452,358,133,141,0,0.4540000259876251,452.5,429,386,358.5,386,288,386,429,519,288,519,429,0.06593465805053711
452,358,133,141,0,0.453000009059906,452.5,429,386,358.5,386,288,386,429,519,288,519,429,0.06691169738769531
452,359,133,142,0,0.453000009059906,452.5,430,386,359.0,386,288,386,430,519,288,519,430,0.06728029251098633
453,358,132,141,0,0.4540000259876251,453.0,429,387,358.5,387,288,387,429,519,288,519,429,0.06606411933898926
453,358,133,141,0,0.4540000259876251,453.5,429,387,358.5,387,288,387,429,520,288,520,429,0.06653547286987305
453,358,133,142,0,0.453000009059906,453.5,429,387,358.0,387,287,387,429,520,287,520,429,0.0670020580291748
454,358,134,142,0,0.45000001788139343,454.0,429,387,358.0,387,287,387,429,521,287,521,429,0.06678962707519531
455,357,134,143,0,0.4520000219345093,455.0,429,388,357.5,388,286,388,429,522,286,522,429,0.06640148162841797
456,356,136,143,0,0.4490000307559967,456.0,428,388,356.5,388,285,388,428,524,285,524,428,0.06627416610717773
457,355,135,144,0,0.45100003480911255,457.5,427,390,355.0,390,283,390,427,525,283,525,427,0.06699848175048828
459,354,136,145,0,0.4480000138282776,459.0,427,391,354.5,391,282,391,427,527,282,527,427,0.06717777252197266
460,353,137,146,0,0.44700002670288086,460.5,426,392,353.0,392,280,392,426,529,280,529,426,0.06640267372131348
462,351,139,147,0,0.4440000355243683,462.5,425,393,351.5,393,278,393,425,532,278,532,425,0.06858348846435547
465,350,141,148,0,0.4440000355243683,465.5,424,395,350.0,395,276,395,424,536,276,536,424,0.06612586975097656
467,349,142,150,0,0.44300001859664917,467.0,424,396,349.0,396,274,396,424,538,274,538,424,0.06529712677001953
469,347,143,151,0,0.43800002336502075,469.5,423,398,347.5,398,272,398,423,541,272,541,423,0.0655820369720459
472,344,143,153,0,0.43800002336502075,472.5,421,401,344.5,401,268,401,421,544,268,544,421,0.067138671875
475,342,146,154,0,0.4360000193119049,475.0,419,402,342.0,402,265,402,419,548,265,548,419,0.06670403480529785
477,341,147,160,0,0.4320000112056732,477.5,421,404,341.0,404,261,404,421,551,261,551,421,0.06681227684020996
481,338,150,160,0,0.4280000329017639,481.0,418,406,338.0,406,258,406,418,556,258,556,418,0.06569385528564453
484,335,153,164,0,0.4270000159740448,484.5,417,408,335.0,408,253,408,417,561,253,561,417,0.0667717456817627
487,337,155,177,0,0.42100003361701965,487.5,426,410,337.5,410,249,410,426,565,249,565,426,0.06645965576171875
491,328,158,169,0,0.42100003361701965,491.0,413,412,328.5,412,244,412,413,570,244,570,413,0.06722640991210938
495,326,162,174,0,0.41600000858306885,495.0,413,414,326.0,414,239,414,413,576,239,576,413,0.06598925590515137
498,319,163,169,0,0.41600000858306885,498.5,404,417,319.5,417,235,417,404,580,235,580,404,0.06725144386291504
500,316,165,172,0,0.4130000174045563,500.5,402,418,316.0,418,230,418,402,583,230,583,402,0.06588268280029297
503,313,167,177,0,0.41100001335144043,503.5,402,420,313.5,420,225,420,402,587,225,587,402,0.06637167930603027
506,314,171,188,0,0.40700000524520874,506.5,408,421,314.0,421,220,421,408,592,220,592,408,0.06713390350341797
509,307,171,182,0,0.40700000524520874,509.5,398,424,307.0,424,216,424,398,595,216,595,398,0.06624817848205566
511,308,173,194,0,0.4050000309944153,511.5,405,425,308.0,425,211,425,405,598,211,598,405,0.06683015823364258
513,300,175,183,0,0.4050000309944153,513.5,392,426,300.5,426,209,426,392,601,209,601,392,0.06784510612487793
515,298,177,187,0,0.4020000100135803,515.5,392,427,298.5,427,205,427,392,604,205,604,392,0.06513571739196777
516,295,179,189,0,0.40300002694129944,516.5,390,427,295.5,427,201,427,390,606,201,606,390,0.06661605834960938
518,289,180,183,0,0.40400001406669617,518.0,381,428,289.5,428,198,428,381,608,198,608,381,0.06739497184753418
519,286,181,183,0,0.40400001406669617,519.5,378,429,286.5,429,195,429,378,610,195,610,378,0.06615662574768066
520,285,183,185,0,0.4000000059604645,520.5,378,429,285.5,429,193,429,378,612,193,612,378,0.06737351417541504
521,284,183,187,0,0.4010000228881836,521.5,378,430,284.5,430,191,430,378,613,191,613,378,0.0655360221862793
522,282,185,187,0,0.4020000100135803,522.5,376,430,282.5,430,189,430,376,615,189,615,376,0.06694483757019043
524,281,184,188,0,0.39900001883506775,524.0,375,432,281.0,432,187,432,375,616,187,616,375,0.06587791442871094
524,280,185,190,0,0.4000000059604645,524.5,375,432,280.0,432,185,432,375,617,185,617,375,0.06623506546020508
524,279,185,190,0,0.4010000228881836,524.5,374,432,279.0,432,184,432,374,617,184,617,374,0.06895065307617188
524,279,185,190,0,0.4010000228881836,524.5,374,432,279.0,432,184,432,374,617,184,617,374,0.0647130012512207
524,279,185,190,0,0.4000000059604645,524.5,374,432,279.0,432,184,432,374,617,184,617,374,0.06852412223815918
524,279,186,189,0,0.4010000228881836,524.0,374,431,279.5,431,185,431,374,617,185,617,374,0.06452322006225586
523,280,186,190,0,0.3970000147819519,523.0,375,430,280.0,430,185,430,375,616,185,616,375,0.06708288192749023
521,280,187,191,0,0.398000031709671,521.5,376,428,280.5,428,185,428,376,615,185,615,376,0.06639981269836426
520,280,186,191,0,0.398000031709671,520.0,376,427,280.5,427,185,427,376,613,185,613,376,0.06694269180297852
518,281,186,190,0,0.3960000276565552,518.0,376,425,281.0,425,186,425,376,611,186,611,376,0.06690835952758789
515,282,186,189,0,0.39500001072883606,515.0,377,422,282.5,422,188,422,377,608,188,608,377,0.06612014770507812
511,283,186,189,0,0.3930000066757202,511.0,378,418,283.5,418,189,418,378,604,189,604,378,0.0662221908569336
507,285,187,189,0,0.3920000195503235,507.5,380,414,285.5,414,191,414,380,601,191,601,380,0.06720376014709473
502,288,187,190,0,0.3880000114440918,502.5,383,409,288.0,409,193,409,383,596,193,596,383,0.06830096244812012
498,290,186,192,0,0.38200002908706665,498.0,386,405,290.0,405,194,405,386,591,194,591,386,0.06593441963195801
492,292,185,192,0,0.3790000081062317,492.5,388,400,292.0,400,196,400,388,585,196,585,388,0.06609368324279785
486,296,186,197,0,0.3760000169277191,486.0,395,393,296.5,393,198,393,395,579,198,579,395,0.06646203994750977
479,298,185,196,0,0.3720000088214874,479.5,396,387,298.0,387,200,387,396,572,200,572,396,0.06866574287414551
471,302,186,196,0,0.36900001764297485,471.0,400,378,302.0,378,204,378,400,564,204,564,400,0.06506681442260742
462,304,185,197,0,0.36400002241134644,462.5,403,370,304.5,370,206,370,403,555,206,555,403,0.0668940544128418
453,308,185,199,0,0.359000027179718,453.5,408,361,308.5,361,209,361,408,546,209,546,408,0.06661725044250488
443,313,184,200,0,0.35500001907348633,443.0,413,351,313.0,351,213,351,413,535,213,535,413,0.06658649444580078
431,317,185,202,0,0.34800001978874207,431.5,418,339,317.0,339,216,339,418,524,216,524,418,0.06579375267028809
419,322,184,204,0,0.34200000762939453,419.0,424,327,322.0,327,220,327,424,511,220,511,424,0.06722545623779297
405,327,183,205,0,0.3360000252723694,405.5,430,314,327.5,314,225,314,430,497,225,497,430,0.06604409217834473
391,333,181,206,0,0.33100003004074097,391.5,436,301,333.0,301,230,301,436,482,230,482,436,0.06590986251831055
375,339,181,209,0,0.3240000009536743,375.5,444,285,339.5,285,235,285,444,466,235,466,444,0.06607723236083984
357,344,183,209,0,0.320000022649765,357.5,449,266,344.5,266,240,266,449,449,240,449,449,0.06697249412536621
340,351,183,212,0,0.3150000274181366,340.5,457,249,351.0,249,245,249,457,432,245,432,457,0.06652975082397461
323,356,184,213,0,0.30900001525878906,323.0,463,231,356.5,231,250,231,463,415,250,415,463,0.06667709350585938
306,361,188,214,0,0.0,306.0,468,212,361.0,212,254,212,468,400,254,400,468,0.06747603416442871
289,367,189,216,0,0.0,289.5,475,195,367.0,195,259,195,475,384,259,384,475,0.06556320190429688
273,371,192,217,0,0.0,273.0,480,177,371.5,177,263,177,480,369,263,369,480,0.06726670265197754
258,373,193,214,0,0.0,258.5,480,162,373.0,162,266,162,480,355,266,355,480,0.06675863265991211
244,375,194,210,0,0.0,244.0,480,147,375.0,147,270,147,480,341,270,341,480,0.06538724899291992
229,377,198,206,0,0.0,229.0,480,130,377.0,130,274,130,480,328,274,328,480,0.067230224609375
217,378,198,204,0,0.2160000056028366,217.0,480,118,378.0,118,276,118,480,316,276,316,480,0.06624221801757812
205,380,200,200,0,0.0,205.0,480,105,380.0,105,280,105,480,305,280,305,480,0.0668954849243164
193,380,201,197,0,0.0,193.5,479,93,380.5,93,282,93,479,294,282,294,479,0.0674142837524414
184,382,202,194,0,0.2150000035762787,184.0,479,83,382.0,83,285,83,479,285,285,285,479,0.06633973121643066
174,383,205,192,0,0.0,174.5,479,72,383.0,72,287,72,479,277,287,277,479,0.06790804862976074
166,383,205,191,0,0.0,166.5,479,64,383.5,64,288,64,479,269,288,269,479,0.06522703170776367
159,384,207,189,0,0.0,159.5,479,56,384.5,56,290,56,479,263,290,263,479,0.06583738327026367
153,385,207,188,0,0.0,153.5,479,50,385.0,50,291,50,479,257,291,257,479,0.06771183013916016
149,386,208,186,0,0.0,149.0,479,45,386.0,45,293,45,479,253,293,253,479,0.06495881080627441
145,386,208,185,0,0.0,145.0,479,41,386.5,41,294,41,479,249,294,249,479,0.06709837913513184
142,386,209,185,0,0.0,142.5,479,38,386.5,38,294,38,479,247,294,247,479,0.06630277633666992
141,386,209,185,0,0.0,141.5,479,37,386.5,37,294,37,479,246,294,246,479,0.06651759147644043
141,386,209,185,0,0.0,141.5,479,37,386.5,37,294,37,479,246,294,246,479,0.0675055980682373
142,386,209,185,0,0.0,142.5,479,38,386.5,38,294,38,479,247,294,247,479,0.06639313697814941
143,386,209,186,0,0.0,143.5,479,39,386.0,39,293,39,479,248,293,248,479,0.06661057472229004
146,386,208,186,0,0.0,146.0,479,42,386.0,42,293,42,479,250,293,250,479,0.06618046760559082
150,384,208,187,0,0.0,150.0,478,46,384.5,46,291,46,478,254,291,254,478,0.06714701652526855
155,384,207,190,0,0.0,155.5,479,52,384.0,52,289,52,479,259,289,259,479,0.067138671875
161,382,205,191,0,0.0,161.5,478,59,382.5,59,287,59,478,264,287,264,478,0.06535744667053223
168,382,204,194,0,0.0,168.0,479,66,382.0,66,285,66,479,270,285,270,479,0.06723952293395996
176,380,203,197,0,0.0,176.5,479,75,380.5,75,282,75,479,278,282,278,479,0.06657814979553223
185,379,201,200,0,0.2150000035762787,185.5,479,85,379.0,85,279,85,479,286,279,286,479,0.06654620170593262
195,377,199,204,0,0.21300001442432404,195.5,479,96,377.0,96,275,96,479,295,275,295,479,0.0674886703491211
205,375,197,207,0,0.2150000035762787,205.5,479,107,375.5,107,272,107,479,304,272,304,479,0.06547403335571289
217,373,196,212,0,0.0,217.0,479,119,373.0,119,267,119,479,315,267,315,479,0.06720495223999023
228,370,193,217,0,0.0,228.5,479,132,370.5,132,262,132,479,325,262,325,479,0.0660700798034668
241,365,191,215,0,0.0,241.5,473,146,365.5,146,258,146,473,337,258,337,473,0.0668478012084961
254,359,190,213,0,0.0,254.0,466,159,359.5,159,253,159,466,349,253,349,466,0.06735110282897949
268,353,186,213,0,0.0,268.0,460,175,353.5,175,247,175,460,361,247,361,460,0.06617236137390137
282,346,185,210,0,0.0,282.5,451,190,346.0,190,241,190,451,375,241,375,451,0.06750082969665527
296,340,182,211,0,0.0,296.0,446,205,340.5,205,235,205,446,387,235,387,446,0.06594085693359375
311,333,181,209,0,0.0,311.5,438,221,333.5,221,229,221,438,402,229,402,438,0.06609392166137695
326,325,178,207,0,0.0,326.0,429,237,325.5,237,222,237,429,415,222,415,429,0.06750679016113281
341,317,176,203,0,0.0,341.0,419,253,317.5,253,216,253,419,429,216,429,419,0.06585288047790527
355,310,175,203,0,0.0,355.5,412,268,310.5,268,209,268,412,443,209,443,412,0.06635618209838867
370,302,171,202,0,0.3400000035762787,370.5,403,285,302.0,285,201,285,403,456,201,456,403,0.06646561622619629
385,294,171,201,0,0.3490000069141388,385.5,395,300,294.5,300,194,300,395,471,194,471,395,0.06693005561828613
400,285,172,197,0,0.3540000021457672,400.0,384,314,285.5,314,187,314,384,486,187,486,384,0.06812787055969238
413,277,171,195,0,0.3660000264644623,413.5,375,328,277.5,328,180,328,375,499,180,499,375,0.06471419334411621
425,270,171,195,0,0.37300002574920654,425.5,368,340,270.5,340,173,340,368,511,173,511,368,0.06831669807434082
436,263,172,194,0,0.38200002908706665,436.0,360,350,263.0,350,166,350,360,522,166,522,360,0.06667184829711914
446,257,171,192,0,0.39000001549720764,446.5,353,361,257.0,361,161,361,353,532,161,532,353,0.06512951850891113
455,250,172,189,0,0.398000031709671,455.0,345,369,250.5,369,156,369,345,541,156,541,345,0.0683140754699707
464,245,173,190,0,0.4020000100135803,464.5,340,378,245.0,378,150,378,340,551,150,551,340,0.06433677673339844
472,240,174,188,0,0.4100000262260437,472.0,334,385,240.0,385,146,385,334,559,146,559,334,0.06752324104309082
479,234,172,187,0,0.42100003361701965,479.0,328,393,234.5,393,141,393,328,565,141,565,328,0.06601071357727051
484,230,173,186,0,0.42100003361701965,484.5,323,398,230.0,398,137,398,323,571,137,571,323,0.0666353702545166
490,225,173,185,0,0.4320000112056732,490.5,318,404,225.5,404,133,404,318,577,133,577,318,0.06692957878112793
495,224,171,186,0,0.43800002336502075,495.5,317,410,224.0,410,131,410,317,581,131,581,317,0.06689667701721191
501,219,172,182,0,0.4410000145435333,501.0,310,415,219.0,415,128,415,310,587,128,587,310,0.06584930419921875
505,216,172,180,0,0.44700002670288086,505.0,306,419,216.0,419,126,419,306,591,126,591,306,0.06667232513427734
509,213,171,181,0,0.4540000259876251,509.5,304,424,213.5,424,123,424,304,595,123,595,304,0.06680536270141602
513,212,170,184,0,0.4580000340938568,513.0,304,428,212.0,428,120,428,304,598,120,598,304,0.06592512130737305
516,209,170,181,0,0.45900002121925354,516.0,300,431,209.5,431,119,431,300,601,119,601,300,0.06767082214355469
519,207,170,180,0,0.46400001645088196,519.0,297,434,207.0,434,117,434,297,604,117,604,297,0.06635475158691406
521,205,169,179,0,0.4740000367164612,521.5,295,437,205.5,437,116,437,295,606,116,606,295,0.06626605987548828
523,203,169,177,0,0.47600001096725464,523.5,292,439,203.5,439,115,439,292,608,115,608,292,0.06642413139343262
525,202,168,176,0,0.4750000238418579,525.0,290,441,202.0,441,114,441,290,609,114,609,290,0.06602597236633301
527,202,168,178,0,0.47600001096725464,527.0,291,443,202.0,443,113,443,291,611,113,611,291,0.06783294677734375
528,201,167,177,0,0.4780000150203705,528.5,290,445,201.5,445,113,445,290,612,113,612,290,0.06636571884155273
529,200,168,177,0,0.4820000231266022,529.0,289,445,200.5,445,112,445,289,613,112,613,289,0.06618881225585938
530,202,168,181,0,0.4790000319480896,530.0,293,446,202.5,446,112,446,293,614,112,614,293,0.06636333465576172
530,201,167,181,0,0.48100003600120544,530.5,292,447,201.5,447,111,447,292,614,111,614,292,0.06716489791870117
530,203,167,184,0,0.48100003600120544,530.5,295,447,203.0,447,111,447,295,614,111,614,295,0.0665593147277832
530,204,167,187,0,0.4780000150203705,530.5,298,447,204.5,447,111,447,298,614,111,614,298,0.06636357307434082
529,204,167,184,0,0.48100003600120544,529.5,296,446,204.0,446,112,446,296,613,112,613,296,0.06695342063903809
528,201,167,177,0,0.4790000319480896,528.5,290,445,201.5,445,113,445,290,612,113,612,290,0.06673502922058105
527,202,166,176,0,0.4830000102519989,527.0,290,444,202.0,444,114,444,290,610,114,610,290,0.06672072410583496
525,204,166,176,0,0.48600003123283386,525.0,292,442,204.0,442,116,442,292,608,116,608,292,0.06641221046447754
523,207,166,179,0,0.48100003600120544,523.0,297,440,207.5,440,118,440,297,606,118,606,297,0.0652008056640625
516,213,165,176,0,0.47300001978874207,516.5,301,434,213.0,434,125,434,301,599,125,599,301,0.0682060718536377
511,220,163,182,0,0.4710000157356262,511.5,311,430,220.0,430,129,430,311,593,129,593,311,0.065704345703125
506,220,161,175,0,0.4750000238418579,506.5,308,426,220.5,426,133,426,308,587,133,587,308,0.06676006317138672
499,224,159,171,0,0.4700000286102295,499.5,310,420,224.5,420,139,420,310,579,139,579,310,0.06663751602172852
493,231,158,173,0,0.4690000116825104,493.0,318,414,231.5,414,145,414,318,572,145,572,318,0.0661933422088623
485,236,155,169,0,0.4650000333786011,485.5,321,408,236.5,408,152,408,321,563,152,563,321,0.0668179988861084
476,244,153,169,0,0.4650000333786011,476.5,329,400,244.5,400,160,400,329,553,160,553,329,0.06708264350891113
468,251,150,166,0,0.4580000340938568,468.0,334,393,251.0,393,168,393,334,543,168,543,334,0.06611895561218262
458,258,148,164,0,0.45900002121925354,458.0,340,384,258.0,384,176,384,340,532,176,532,340,0.0670166015625
447,268,145,169,0,0.45500001311302185,447.5,353,375,268.5,375,184,375,353,520,184,520,353,0.06688237190246582
435,274,141,160,0,0.45600003004074097,435.5,354,365,274.0,365,194,365,354,506,194,506,354,0.06616973876953125
424,281,139,159,0,0.4540000259876251,424.5,361,355,281.5,355,202,355,361,494,202,494,361,0.06677651405334473
414,288,134,156,0,0.4520000219345093,414.0,366,347,288.0,347,210,347,366,481,210,481,366,0.06637048721313477
405,294,130,154,0,0.44600000977516174,405.0,371,340,294.0,340,217,340,371,470,217,470,371,0.06670141220092773
396,301,128,155,0,0.44700002670288086,396.0,379,332,301.5,332,224,332,379,460,224,460,379,0.06768941879272461
388,305,126,152,0,0.45000001788139343,388.0,381,325,305.0,325,229,325,381,451,229,451,381,0.0655202865600586
380,309,122,149,0,0.4480000138282776,380.0,384,319,309.5,319,235,319,384,441,235,441,384,0.06685853004455566
373,313,121,147,0,0.44300001859664917,373.5,387,313,313.5,313,240,313,387,434,240,434,387,0.06583952903747559
367,317,119,148,0,0.445000022649765,367.5,391,308,317.0,308,243,308,391,427,243,427,391,0.06679415702819824
361,320,117,146,0,0.445000022649765,361.5,393,303,320.0,303,247,303,393,420,247,420,393,0.06691932678222656
357,323,118,144,0,0.445000022649765,357.0,395,298,323.0,298,251,298,395,416,251,416,395,0.06651926040649414
353,325,116,142,0,0.4440000355243683,353.0,396,295,325.0,295,254,295,396,411,254,411,396,0.06785345077514648
350,327,114,142,0,0.44600000977516174,350.0,398,293,327.0,293,256,293,398,407,256,407,398,0.06515002250671387
347,328,114,142,0,0.44600000977516174,347.0,399,290,328.0,290,257,290,399,404,257,404,399,0.06699585914611816
345,329,114,141,0,0.44700002670288086,345.0,400,288,329.5,288,259,288,400,402,259,402,400,0.06614518165588379
344,329,114,141,0,0.4490000307559967,344.0,400,287,329.5,287,259,287,400,401,259,401,400,0.06703519821166992
344,329,114,141,0,0.4480000138282776,344.0,400,287,329.5,287,259,287,400,401,259,401,400,0.0666055679321289
344,329,114,141,0,0.4490000307559967,344.0,400,287,329.5,287,259,287,400,401,259,401,400,0.06622076034545898
343,329,114,141,0,0.4490000307559967,343.0,400,286,329.5,286,259,286,400,400,259,400,400,0.06774187088012695
342,328,114,141,0,0.45100003480911255,342.0,399,285,328.5,285,258,285,399,399,258,399,399,0.06550359725952148
340,328,115,141,0,0.45000001788139343,340.5,399,283,328.5,283,258,283,399,398,258,398,399,0.06649398803710938
338,328,114,140,0,0.45000001788139343,338.0,398,281,328.0,281,258,281,398,395,258,395,398,0.0673072338104248
336,327,115,141,0,0.4520000219345093,336.5,398,279,327.5,279,257,279,398,394,257,394,398,0.06583023071289062
333,325,114,141,0,0.4540000259876251,333.0,396,276,325.5,276,255,276,396,390,255,390,396,0.06796026229858398
329,324,113,140,0,0.45500001311302185,329.5,394,273,324.0,273,254,273,394,386,254,386,394,0.06527018547058105
324,323,113,138,0,0.4570000171661377,324.5,392,268,323.0,268,254,268,392,381,254,381,392,0.06756472587585449
319,321,113,138,0,0.45600003004074097,319.5,390,263,321.0,263,252,263,390,376,252,376,390,0.0664680004119873
314,318,113,139,0,0.45100003480911255,314.5,388,258,318.5,258,249,258,388,371,249,371,388,0.06574368476867676
308,316,113,140,0,0.4320000112056732,308.5,386,252,316.0,252,246,252,386,365,246,365,386,0.06804585456848145
303,312,113,139,0,0.42000001668930054,303.5,382,247,312.5,247,243,247,382,360,243,360,382,0.06542277336120605
297,310,112,139,0,0.4190000295639038,297.0,380,241,310.5,241,241,241,380,353,241,353,380,0.06693816184997559
290,307,112,139,0,0.4130000174045563,290.0,377,234,307.5,234,238,234,377,346,238,346,377,0.06651663780212402
282,304,113,138,0,0.4130000174045563,282.5,373,226,304.0,226,235,226,373,339,235,339,373,0.06642270088195801
275,300,113,136,0,0.41100001335144043,275.5,368,219,300.0,219,232,219,368,332,232,332,368,0.06703901290893555
268,296,112,139,0,0.40800002217292786,268.0,366,212,296.5,212,227,212,366,324,227,324,366,0.06634306907653809
259,292,112,137,0,0.41200003027915955,259.0,361,203,292.5,203,224,203,361,315,224,315,361,0.06658315658569336
250,289,113,137,0,0.4140000343322754,250.5,358,194,289.5,194,221,194,358,307,221,307,358,0.06673741340637207
242,283,112,137,0,0.41100001335144043,242.0,352,186,283.5,186,215,186,352,298,215,298,352,0.0670461654663086
232,278,111,137,0,0.4140000343322754,232.5,347,177,278.5,177,210,177,347,288,210,288,347,0.06623411178588867
224,275,112,140,0,0.0,224.0,345,168,275.0,168,205,168,345,280,205,280,345,0.06662583351135254
214,268,111,136,0,0.0,214.5,336,159,268.0,159,200,159,336,270,200,270,336,0.06640243530273438
207,263,112,137,0,0.0,207.0,332,151,263.5,151,195,151,332,263,195,263,332,0.0663752555847168
199,259,111,138,0,0.0,199.5,328,144,259.0,144,190,144,328,255,190,255,328,0.06703782081604004
191,254,111,136,0,0.0,191.5,322,136,254.0,136,186,136,322,247,186,247,322,0.06653666496276855
184,249,111,137,0,0.0,184.5,318,129,249.5,129,181,129,318,240,181,240,318,0.06658649444580078
178,245,111,136,0,0.492000013589859,178.5,313,123,245.0,123,177,123,313,234,177,234,313,0.06767392158508301
172,241,111,136,0,0.0,172.5,309,117,241.0,117,173,117,309,228,173,228,309,0.06510472297668457
167,236,111,135,0,0.0,167.5,304,112,236.5,112,169,112,304,223,169,223,304,0.06784605979919434
162,234,111,138,0,0.49900001287460327,162.5,303,107,234.0,107,165,107,303,218,165,218,303,0.06560587882995605
158,232,111,140,0,0.49900001287460327,158.5,302,103,232.0,103,162,103,302,214,162,214,302,0.0671694278717041
153,230,111,142,0,0.5010000467300415,153.5,301,98,230.0,98,159,98,301,209,159,209,301,0.06768345832824707
150,226,110,141,0,0.503000020980835,150.0,297,95,226.5,95,156,95,297,205,156,205,297,0.06528401374816895
146,223,111,139,0,0.5100000500679016,146.5,293,91,223.5,91,154,91,293,202,154,202,293,0.06660079956054688
144,220,111,136,0,0.5110000371932983,144.5,288,89,220.0,89,152,89,288,200,152,200,288,0.06661128997802734
141,218,110,139,0,0.5139999985694885,141.0,288,86,218.5,86,149,86,288,196,149,196,288,0.06817746162414551
139,216,110,139,0,0.5070000290870667,139.0,286,84,216.5,84,147,84,286,194,147,194,286,0.06529474258422852
137,214,110,138,0,0.5100000500679016,137.0,283,82,214.0,82,145,82,283,192,145,192,283,0.06615090370178223
135,214,111,138,0,0.5070000290870667,135.5,283,80,214.0,80,145,80,283,191,145,191,283,0.06710505485534668
134,212,111,136,0,0.5139999985694885,134.5,280,79,212.0,79,144,79,280,190,144,190,280,0.06610941886901855
134,211,110,137,0,0.5139999985694885,134.0,280,79,211.5,79,143,79,280,189,143,189,280,0.06665897369384766
133,215,110,144,0,0.5120000243186951,133.0,287,78,215.0,78,143,78,287,188,143,188,287,0.06650018692016602
133,212,110,140,0,0.5139999985694885,133.0,282,78,212.0,78,142,78,282,188,142,188,282,0.0665745735168457
133,212,110,140,0,0.5130000114440918,133.0,282,78,212.0,78,142,78,282,188,142,188,282,0.0668478012084961
134,211,110,139,0,0.5120000243186951,134.0,281,79,211.5,79,142,79,281,189,142,189,281,0.0661923885345459
134,212,111,138,0,0.5060000419616699,134.5,281,79,212.0,79,143,79,281,190,143,190,281,0.06703543663024902
136,211,111,137,0,0.5120000243186951,136.5,280,81,211.5,81,143,81,280,192,143,192,280,0.06609368324279785
137,213,111,138,0,0.5110000371932983,137.5,282,82,213.0,82,144,82,282,193,144,193,282,0.06714844703674316
139,213,111,138,0,0.5080000162124634,139.5,282,84,213.0,84,144,84,282,195,144,195,282,0.06715631484985352
142,213,111,138,0,0.5120000243186951,142.5,282,87,213.0,87,144,87,282,198,144,198,282,0.06577706336975098
145,214,112,137,0,0.5020000338554382,145.0,283,89,214.5,89,146,89,283,201,146,201,283,0.06712460517883301
148,216,111,140,0,0.5020000338554382,148.5,286,93,216.0,93,146,93,286,204,146,204,286,0.06668400764465332
152,216,112,140,0,0.5010000467300415,152.0,286,96,216.0,96,146,96,286,208,146,208,286,0.06646466255187988
156,220,111,144,0,0.5020000338554382,156.5,292,101,220.0,101,148,101,292,212,148,212,292,0.06774663925170898
161,219,112,140,0,0.5090000033378601,161.0,289,105,219.0,105,149,105,289,217,149,217,289,0.06622099876403809
166,220,113,141,0,0.4960000216960907,166.5,291,110,220.5,110,150,110,291,223,150,223,291,0.0656440258026123
171,221,113,140,0,0.0,171.5,291,115,221.0,115,151,115,291,228,151,228,291,0.0669701099395752
178,223,114,141,0,0.0,178.0,294,121,223.5,121,153,121,294,235,153,235,294,0.0661458969116211
184,224,113,141,0,0.4020000100135803,184.5,295,128,224.5,128,154,128,295,241,154,241,295,0.06668519973754883
192,228,114,147,0,0.3970000147819519,192.0,302,135,228.5,135,155,135,302,249,155,249,302,0.06628131866455078
200,228,114,145,0,0.0,200.0,301,143,228.5,143,156,143,301,257,156,257,301,0.06706643104553223
209,230,116,146,0,0.0,209.0,303,151,230.0,151,157,151,303,267,157,267,303,0.0667874813079834
217,230,115,145,0,0.0,217.5,303,160,230.5,160,158,160,303,275,158,275,303,0.06590747833251953
227,232,116,146,0,0.0,227.0,305,169,232.0,169,159,169,305,285,159,285,305,0.0673379898071289
238,233,117,144,0,0.43800002336502075,238.5,305,180,233.0,180,161,180,305,297,161,297,305,0.06717801094055176
249,234,119,145,0,0.4320000112056732,249.5,307,190,234.5,190,162,190,307,309,162,309,307,0.0661780834197998
262,235,120,149,0,0.4310000240802765,262.0,310,202,235.5,202,161,202,310,322,161,322,310,0.06720280647277832
275,236,120,149,0,0.4400000274181366,275.0,311,215,236.5,215,162,215,311,335,162,335,311,0.0662076473236084
289,237,120,151,0,0.4410000145435333,289.0,313,229,237.5,229,162,229,313,349,162,349,313,0.06680631637573242
304,238,124,153,0,0.0,304.0,315,242,238.5,242,162,242,315,366,162,366,315,0.06593585014343262
318,239,124,154,0,0.0,318.0,316,256,239.0,256,162,256,316,380,162,380,316,0.06688833236694336
333,239,124,155,0,0.0,333.0,317,271,239.5,271,162,271,317,395,162,395,317,0.0665888786315918
347,239,124,157,0,0.0,347.0,318,285,239.5,285,161,285,318,409,161,409,318,0.0662233829498291
361,239,128,157,0,0.0,361.0,318,297,239.5,297,161,297,318,425,161,425,318,0.06738090515136719
374,239,129,159,0,0.0,374.5,319,310,239.5,310,160,310,319,439,160,439,319,0.06622910499572754
387,239,131,160,0,0.0,387.5,319,322,239.0,322,159,322,319,453,159,453,319,0.06619739532470703
400,238,134,161,0,0.4650000333786011,400.0,319,333,238.5,333,158,333,319,467,158,467,319,0.0670163631439209
411,237,137,163,0,0.46000000834465027,411.5,319,343,237.5,343,156,343,319,480,156,480,319,0.06573772430419922
422,237,140,162,0,0.46000000834465027,422.0,318,352,237.0,352,156,352,318,492,156,492,318,0.06821680068969727
432,236,143,165,0,0.45600003004074097,432.5,319,361,236.5,361,154,361,319,504,154,504,319,0.06571507453918457
443,234,145,165,0,0.46300002932548523,443.5,317,371,234.5,371,152,371,317,516,152,516,317,0.06668615341186523
453,233,149,166,0,0.45900002121925354,453.5,316,379,233.0,379,150,379,316,528,150,528,316,0.06640148162841797
462,232,151,167,0,0.46400001645088196,462.5,316,387,232.5,387,149,387,316,538,149,538,316,0.06601548194885254
471,231,154,170,0,0.4620000123977661,471.0,316,394,231.0,394,146,394,316,548,146,548,316,0.06703305244445801
479,230,155,171,0,0.4620000123977661,479.5,316,402,230.5,402,145,402,316,557,145,557,316,0.06771326065063477
487,229,158,171,0,0.4620000123977661,487.0,315,408,229.5,408,144,408,315,566,144,566,315,0.06537675857543945
493,228,159,172,0,0.46300002932548523,493.5,314,414,228.0,414,142,414,314,573,142,573,314,0.06682753562927246
499,228,161,174,0,0.4610000252723694,499.5,315,419,228.0,419,141,419,315,580,141,580,315,0.0664818286895752
505,226,162,173,0,0.4620000123977661,505.0,313,424,226.5,424,140,424,313,586,140,586,313,0.06673264503479004
509,225,165,173,0,0.46400001645088196,509.5,312,427,225.5,427,139,427,312,592,139,592,312,0.0669856071472168
513,225,165,174,0,0.4660000205039978,513.5,312,431,225.0,431,138,431,312,596,138,596,312,0.06641554832458496
517,224,167,175,0,0.46400001645088196,517.5,312,434,224.5,434,137,434,312,601,137,601,312,0.06623387336730957
519,224,167,176,0,0.4620000123977661,519.5,312,436,224.0,436,136,436,312,603,136,603,312,0.0665900707244873
522,228,168,185,0,0.46000000834465027,522.0,321,438,228.5,438,136,438,321,606,136,606,321,0.0665903091430664
523,227,168,184,0,0.45900002121925354,523.0,319,439,227.0,439,135,439,319,607,135,607,319,0.06671476364135742
523,227,168,185,0,0.4610000252723694,523.0,320,439,227.5,439,135,439,320,607,135,607,320,0.06624460220336914
523,227,168,183,0,0.45900002121925354,523.0,319,439,227.5,439,136,439,319,607,136,607,319,0.06699538230895996
522,227,168,182,0,0.46000000834465027,522.0,318,438,227.0,438,136,438,318,606,136,606,318,0.06660914421081543
521,226,168,179,0,0.4620000123977661,521.0,316,437,226.5,437,137,437,316,605,137,605,316,0.06690263748168945
519,225,167,176,0,0.46800002455711365,519.5,313,436,225.0,436,137,436,313,603,137,603,313,0.06670403480529785
517,226,166,175,0,0.46700000762939453,517.0,314,434,226.5,434,139,434,314,600,139,600,314,0.06628727912902832
514,227,164,173,0,0.4650000333786011,514.0,314,432,227.5,432,141,432,314,596,141,596,314,0.06646323204040527
510,229,164,173,0,0.4660000205039978,510.0,316,428,229.5,428,143,428,316,592,143,592,316,0.0666804313659668
505,229,161,171,0,0.46800002455711365,505.5,315,425,229.5,425,144,425,315,586,144,586,315,0.06862521171569824
500,231,159,170,0,0.4660000205039978,500.5,316,421,231.0,421,146,421,316,580,146,580,316,0.06503582000732422
496,233,158,170,0,0.4660000205039978,496.0,318,417,233.0,417,148,417,318,575,148,575,318,0.06635880470275879
491,235,156,169,0,0.46800002455711365,491.0,320,413,235.5,413,151,413,320,569,151,569,320,0.06745362281799316
485,239,154,168,0,0.4660000205039978,485.0,323,408,239.0,408,155,408,323,562,155,562,323,0.0656440258026123
478,242,151,166,0,0.46700000762939453,478.5,325,403,242.0,403,159,403,325,554,159,554,325,0.06667447090148926
472,242,148,163,0,0.46800002455711365,472.0,324,398,242.5,398,161,398,324,546,161,546,324,0.06683111190795898
464,243,145,161,0,0.47300001978874207,464.5,324,392,243.5,392,163,392,324,537,163,537,324,0.06754112243652344
456,247,143,163,0,0.47200003266334534,456.5,329,385,247.5,385,166,385,329,528,166,528,329,0.06516766548156738
448,253,140,167,0,0.4690000116825104,448.0,337,378,253.5,378,170,378,337,518,170,518,337,0.06737279891967773
439,251,135,155,0,0.4780000150203705,439.5,329,372,251.5,372,174,372,329,507,174,507,329,0.0668632984161377
431,253,132,153,0,0.4790000319480896,431.0,330,365,253.5,365,177,365,330,497,177,497,330,0.06604170799255371
421,254,131,151,0,0.484000027179718,421.5,330,356,254.5,356,179,356,330,487,179,487,330,0.06626129150390625
412,255,126,149,0,0.48500001430511475,412.0,330,349,255.5,349,181,349,330,475,181,475,330,0.06677651405334473
402,258,123,146,0,0.4820000231266022,402.5,331,341,258.0,341,185,341,331,464,185,464,331,0.06701874732971191
392,260,121,144,0,0.48900002241134644,392.5,332,332,260.0,332,188,332,332,453,188,453,332,0.0660402774810791
382,262,117,142,0,0.4960000216960907,382.5,333,324,262.0,324,191,324,333,441,191,441,333,0.06730031967163086
372,263,113,141,0,0.0,372.5,334,316,263.5,316,193,316,334,429,193,429,334,0.06618070602416992
361,264,111,139,0,0.0,361.5,334,306,264.5,306,195,306,334,417,195,417,334,0.06625533103942871
350,265,109,136,0,0.0,350.5,333,296,265.0,296,197,296,333,405,197,405,333,0.06715774536132812
339,266,106,134,0,0.0,339.0,333,286,266.0,286,199,286,333,392,199,392,333,0.06611037254333496
327,267,104,132,0,0.4310000240802765,327.0,333,275,267.0,275,201,275,333,379,201,379,333,0.06700801849365234
315,266,103,129,0,0.43400001525878906,315.5,331,264,266.5,264,202,264,331,367,202,367,331,0.06685161590576172
304,266,102,128,0,0.4440000355243683,304.0,330,253,266.0,253,202,253,330,355,202,355,330,0.06633257865905762
293,266,100,127,0,0.453000009059906,293.0,330,243,266.5,243,203,243,330,343,203,343,330,0.06714010238647461
282,267,98,128,0,0.46000000834465027,282.0,331,233,267.0,233,203,233,331,331,203,331,331,0.06606888771057129
272,265,97,125,0,0.4650000333786011,272.5,328,224,265.5,224,203,224,328,321,203,321,328,0.06695795059204102
263,264,96,122,0,0.47600001096725464,263.0,325,215,264.0,215,203,215,325,311,203,311,325,0.06646561622619629
254,262,95,121,0,0.48100003600120544,254.5,323,207,262.5,207,202,207,323,302,202,302,323,0.06640267372131348
246,260,94,118,0,0.4880000352859497,246.0,319,199,260.0,199,201,199,319,293,201,293,319,0.06700825691223145
238,260,92,118,0,0.49900001287460327,238.0,319,192,260.0,192,201,192,319,284,201,284,319,0.06618785858154297
230,258,91,116,0,0.0,230.5,316,185,258.0,185,200,185,316,276,200,276,316,0.06743812561035156
224,256,92,116,0,0.5470000505447388,224.0,314,178,256.0,178,198,178,314,270,198,270,314,0.06594324111938477
217,254,91,115,0,0.5580000281333923,217.5,312,172,254.5,172,197,172,312,263,197,263,312,0.06619739532470703
211,253,90,115,0,0.5710000395774841,211.0,311,166,253.5,166,196,166,311,256,196,256,311,0.06678247451782227
205,252,89,114,0,0.5790000557899475,205.5,309,161,252.0,161,195,161,309,250,195,250,309,0.06628251075744629
199,250,89,112,0,0.5830000042915344,199.5,306,155,250.0,155,194,155,306,244,194,244,306,0.06653308868408203
194,250,89,115,0,0.5900000333786011,194.5,308,150,250.5,150,193,150,308,239,193,239,308,0.06670856475830078
190,254,89,124,0,0.5820000171661377,190.5,316,146,254.0,146,192,146,316,235,192,235,316,0.06627917289733887
186,252,88,124,0,0.5830000042915344,186.0,314,142,252.0,142,190,142,314,230,190,230,314,0.067047119140625
182,245,88,113,0,0.5990000367164612,182.0,302,138,245.5,138,189,138,302,226,189,226,302,0.06678605079650879
179,245,88,115,0,0.593000054359436,179.0,303,135,245.5,135,188,135,303,223,188,223,303,0.06619477272033691
175,247,87,122,0,0.5980000495910645,175.5,308,132,247.0,132,186,132,308,219,186,219,308,0.06781888008117676
172,246,87,121,0,0.5990000367164612,172.5,307,129,246.5,129,186,129,307,216,186,216,307,0.06550121307373047
170,243,86,117,0,0.6060000061988831,170.0,302,127,243.5,127,185,127,302,213,185,213,302,0.06693077087402344
167,241,86,115,0,0.609000027179718,167.0,299,124,241.5,124,184,124,299,210,184,210,299,0.06609272956848145
165,238,87,109,0,0.6110000014305115,165.5,293,122,238.5,122,184,122,293,209,184,209,293,0.06780505180358887
164,237,86,108,0,0.6190000176429749,164.0,291,121,237.0,121,183,121,291,207,183,207,291,0.06619834899902344
162,236,87,109,0,0.6110000014305115,162.5,291,119,236.5,119,182,119,291,206,182,206,291,0.06670069694519043
161,236,87,111,0,0.6160000562667847,161.5,292,118,236.5,118,181,118,292,205,181,205,292,0.06632661819458008
160,236,87,111,0,0.625,160.5,292,117,236.5,117,181,117,292,204,181,204,292,0.06715178489685059
160,236,87,111,0,0.6140000224113464,160.5,292,117,236.5,117,181,117,292,204,181,204,292,0.06616973876953125
160,236,86,111,0,0.612000048160553,160.0,292,117,236.5,117,181,117,292,203,181,203,292,0.06645488739013672
160,236,86,111,0,0.6130000352859497,160.0,292,117,236.5,117,181,117,292,203,181,203,292,0.06652021408081055
160,237,87,112,0,0.6210000514984131,160.5,293,117,237.0,117,181,117,293,204,181,204,293,0.06733822822570801
161,236,87,111,0,0.6160000562667847,161.5,292,118,236.5,118,181,118,292,205,181,205,292,0.06562352180480957
162,236,86,110,0,0.6190000176429749,162.0,291,119,236.0,119,181,119,291,205,181,205,291,0.0668179988861084
164,235,86,109,0,0.6140000224113464,164.0,290,121,235.5,121,181,121,290,207,181,207,290,0.0673987865447998
166,236,86,109,0,0.6160000562667847,166.0,291,123,236.5,123,182,123,291,209,182,209,291,0.06633853912353516
168,236,86,109,0,0.6150000095367432,168.0,291,125,236.5,125,182,125,291,211,182,211,291,0.06655335426330566
171,237,85,111,0,0.6140000224113464,171.5,293,129,237.5,129,182,129,293,214,182,214,293,0.06658744812011719
175,238,87,110,0,0.609000027179718,175.5,293,132,238.0,132,183,132,293,219,183,219,293,0.06672310829162598
179,237,86,109,0,0.6110000014305115,179.0,292,136,237.5,136,183,136,292,222,183,222,292,0.0664975643157959
183,237,86,109,0,0.612000048160553,183.0,292,140,237.5,140,183,140,292,226,183,226,292,0.06696557998657227
188,239,86,112,0,0.6080000400543213,188.0,295,145,239.0,145,183,145,295,231,183,231,295,0.06661725044250488
193,239,87,110,0,0.6050000190734863,193.5,294,150,239.0,150,184,150,294,237,184,237,294,0.06639909744262695
199,239,86,110,0,0.6060000061988831,199.0,294,156,239.0,156,184,156,294,242,184,242,294,0.06673622131347656
205,240,87,113,0,0.5960000157356262,205.5,297,162,240.5,162,184,162,297,249,184,249,297,0.06667804718017578
212,240,87,112,0,0.5890000462532043,212.5,296,169,240.0,169,184,169,296,256,184,256,296,0.06604743003845215
219,241,87,112,0,0.5879999995231628,219.5,297,176,241.0,176,185,176,297,263,185,263,297,0.06679916381835938
227,241,87,113,0,0.0,227.5,298,184,241.5,184,185,184,298,271,185,271,298,0.06765031814575195
236,241,88,113,0,0.0,236.0,298,192,241.5,192,185,192,298,280,185,280,298,0.0658102035522461
245,241,88,114,0,0.5410000085830688,245.0,298,201,241.0,201,184,201,298,289,184,289,298,0.0663454532623291
255,241,88,113,0,0.5470000505447388,255.0,298,211,241.5,211,185,211,298,299,185,299,298,0.06627535820007324
265,240,87,112,0,0.5600000023841858,265.5,296,222,240.0,222,184,222,296,309,184,309,296,0.06730484962463379
276,241,88,115,0,0.5490000247955322,276.0,299,232,241.5,232,184,232,299,320,184,320,299,0.06629681587219238
288,240,88,114,0,0.578000009059906,288.0,297,244,240.0,244,183,244,297,332,183,332,297,0.06656146049499512
300,239,88,113,0,0.5710000395774841,300.0,296,256,239.5,256,183,256,296,344,183,344,296,0.06704258918762207
312,239,89,114,0,0.0,312.5,296,268,239.0,268,182,268,296,357,182,357,296,0.06639409065246582
325,238,89,114,0,0.0,325.5,295,281,238.0,281,181,281,295,370,181,370,295,0.06592655181884766
339,236,90,113,0,0.5210000276565552,339.0,293,294,236.5,294,180,294,293,384,180,384,293,0.06743216514587402
351,235,90,115,0,0.0,351.0,293,306,235.5,306,178,306,293,396,178,396,293,0.06559514999389648
363,234,90,114,0,0.0,363.0,291,318,234.0,318,177,318,291,408,177,408,291,0.06715655326843262
374,233,92,113,0,0.6350000500679016,374.0,290,328,233.5,328,177,328,290,420,177,420,290,0.0668325424194336
384,232,93,115,0,0.6350000500679016,384.5,290,338,232.5,338,175,338,290,431,175,431,290,0.06619095802307129
395,231,94,116,0,0.6350000500679016,395.0,289,348,231.0,348,173,348,289,442,173,442,289,0.06742215156555176
404,230,95,116,0,0.6330000162124634,404.5,288,357,230.0,357,172,357,288,452,172,452,288,0.06540775299072266
413,229,97,118,0,0.6340000033378601,413.5,288,365,229.0,365,170,365,288,462,170,462,288,0.0671234130859375
422,228,99,118,0,0.6370000243186951,422.5,287,373,228.0,373,169,373,287,472,169,472,287,0.06718611717224121
430,226,101,117,0,0.6380000114440918,430.5,285,380,226.5,380,168,380,285,481,168,481,285,0.06674551963806152
438,225,101,117,0,0.6420000195503235,438.5,284,388,225.5,388,167,388,284,489,167,489,284,0.06685614585876465
446,224,102,119,0,0.6490000486373901,446.0,284,395,224.5,395,165,395,284,497,165,497,284,0.0659799575805664
452,223,103,119,0,0.6500000357627869,452.5,283,401,223.5,401,164,401,283,504,164,504,283,0.06653904914855957
459,222,104,121,0,0.6470000147819519,459.0,283,407,222.5,407,162,407,283,511,162,511,283,0.06724929809570312
464,223,105,122,0,0.6420000195503235,464.5,284,412,223.0,412,162,412,284,517,162,517,284,0.06617569923400879
470,220,106,120,0,0.6530000567436218,470.0,280,417,220.0,417,160,417,280,523,160,523,280,0.06669950485229492
474,218,106,119,0,0.6490000486373901,474.0,278,421,218.5,421,159,421,278,527,159,527,278,0.06638240814208984
478,217,107,119,0,0.6550000309944153,478.5,277,425,217.5,425,158,425,277,532,158,532,277,0.0666816234588623
482,218,108,120,0,0.6550000309944153,482.0,278,428,218.0,428,158,428,278,536,158,536,278,0.06684756278991699
486,217,108,121,0,0.6500000357627869,486.0,278,432,217.5,432,157,432,278,540,157,540,278,0.0664205551147461
488,218,109,124,0,0.6580000519752502,488.5,280,434,218.0,434,156,434,280,543,156,543,280,0.06665778160095215
490,217,109,123,0,0.6580000519752502,490.5,279,436,217.5,436,156,436,279,545,156,545,279,0.06617093086242676
492,217,108,125,0,0.6580000519752502,492.0,280,438,217.5,438,155,438,280,546,155,546,280,0.06707572937011719
493,219,109,129,0,0.6440000534057617,493.5,284,439,219.5,439,155,439,284,548,155,548,284,0.06668376922607422
493,221,109,132,0,0.6510000228881836,493.5,287,439,221.0,439,155,439,287,548,155,548,287,0.06632161140441895
493,220,109,131,0,0.6510000228881836,493.5,286,439,220.5,439,155,439,286,548,155,548,286,0.06667423248291016
493,220,109,130,0,0.6530000567436218,493.5,285,439,220.0,439,155,439,285,548,155,548,285,0.06601285934448242
493,220,109,131,0,0.6530000567436218,493.5,286,439,220.5,439,155,439,286,548,155,548,286,0.06682419776916504
493,219,108,128,0,0.6570000052452087,493.0,283,439,219.0,439,155,439,283,547,155,547,283,0.06696414947509766
491,217,109,125,0,0.6570000052452087,491.5,280,437,217.5,437,155,437,280,546,155,546,280,0.06618428230285645
491,216,109,123,0,0.6600000262260437,491.5,278,437,216.5,437,155,437,278,546,155,546,278,0.06692004203796387
490,217,110,123,0,0.6550000309944153,490.0,279,435,217.5,435,156,435,279,545,156,545,279,0.06635856628417969
489,218,109,124,0,0.6480000019073486,489.5,280,435,218.0,435,156,435,280,544,156,544,280,0.06755304336547852
488,218,110,125,0,0.6510000228881836,488.0,281,433,218.5,433,156,433,281,543,156,543,281,0.06656646728515625
486,218,109,123,0,0.6470000147819519,486.5,280,432,218.5,432,157,432,280,541,157,541,280,0.06573057174682617
485,219,110,123,0,0.64000004529953,485.0,281,430,219.5,430,158,430,281,540,158,540,281,0.06829619407653809
483,220,110,125,0,0.6310000419616699,483.0,283,428,220.5,428,158,428,283,538,158,538,283,0.06507015228271484
481,225,110,133,0,0.6270000338554382,481.0,292,426,225.5,426,159,426,292,536,159,536,292,0.06681084632873535
479,226,111,133,0,0.6260000467300415,479.5,293,424,226.5,424,160,424,293,535,160,535,293,0.06686091423034668
476,226,111,131,0,0.6260000467300415,476.5,292,421,226.5,421,161,421,292,532,161,532,292,0.06641244888305664
474,227,110,131,0,0.6220000386238098,474.0,293,419,227.5,419,162,419,293,529,162,529,293,0.06658744812011719
471,227,111,131,0,0.6160000562667847,471.5,293,416,227.5,416,162,416,293,527,162,527,293,0.06643223762512207
468,230,111,132,0,0.6140000224113464,468.5,296,413,230.0,413,164,413,296,524,164,524,296,0.06749606132507324
465,233,111,135,0,0.6080000400543213,465.5,301,410,233.5,410,166,410,301,521,166,521,301,0.06614255905151367
462,235,110,134,0,0.5980000495910645,462.0,302,407,235.0,407,168,407,302,517,168,517,302,0.06567716598510742
457,234,111,130,0,0.5950000286102295,457.5,299,402,234.0,402,169,402,299,513,169,513,299,0.06758618354797363
453,236,111,130,0,0.5940000414848328,453.5,301,398,236.0,398,171,398,301,509,171,509,301,0.0661461353302002
449,239,111,131,0,0.5870000123977661,449.5,305,394,239.5,394,174,394,305,505,174,505,305,0.06610918045043945
444,240,111,129,0,0.5830000042915344,444.5,305,389,240.5,389,176,389,305,500,176,500,305,0.06775164604187012
439,242,111,127,0,0.578000009059906,439.5,306,384,242.5,384,179,384,306,495,179,495,306,0.06526303291320801
434,245,110,127,0,0.5730000138282776,434.0,309,379,245.5,379,182,379,309,489,182,489,309,0.06694841384887695
427,250,111,129,0,0.5670000314712524,427.5,315,372,250.5,372,186,372,315,483,186,483,315,0.06714820861816406
421,253,111,128,0,0.5580000281333923,421.5,317,366,253.0,366,189,366,317,477,189,477,317,0.06594538688659668
414,258,110,130,0,0.5470000505447388,414.0,323,359,258.0,359,193,359,323,469,193,469,323,0.06682181358337402
407,263,109,132,0,0.5400000214576721,407.5,329,353,263.0,353,197,353,329,462,197,462,329,0.06885194778442383
399,269,109,134,0,0.531000018119812,399.5,336,345,269.0,345,202,345,336,454,202,454,336,0.06474709510803223
392,272,109,132,0,0.5220000147819519,392.5,338,338,272.0,338,206,338,338,447,206,447,338,0.06670284271240234
385,276,108,132,0,0.5060000419616699,385.0,342,331,276.0,331,210,331,342,439,210,439,342,0.0663905143737793
377,280,108,133,0,0.4960000216960907,377.0,347,323,280.5,323,214,323,347,431,214,431,347,0.06626605987548828
370,285,108,132,0,0.48500001430511475,370.0,351,316,285.0,316,219,316,351,424,219,424,351,0.06740117073059082
362,289,107,133,0,0.492000013589859,362.5,356,309,289.5,309,223,309,356,416,223,416,356,0.06580758094787598
355,293,107,133,0,0.48100003600120544,355.5,360,302,293.5,302,227,302,360,409,227,409,360,0.06708049774169922
348,298,106,132,0,0.484000027179718,348.0,364,295,298.0,295,232,295,364,401,232,401,364,0.06621980667114258
341,302,108,133,0,0.47700002789497375,341.0,369,287,302.5,287,236,287,369,395,236,395,369,0.06803035736083984
334,305,107,133,0,0.47700002789497375,334.5,372,281,305.5,281,239,281,372,388,239,388,372,0.06577563285827637
326,309,107,134,0,0.4790000319480896,326.5,376,273,309.0,273,242,273,376,380,242,380,376,0.06637048721313477
320,313,109,134,0,0.47300001978874207,320.5,380,266,313.0,266,246,266,380,375,246,375,380,0.06597256660461426
314,317,108,134,0,0.47200003266334534,314.0,384,260,317.0,260,250,260,384,368,250,368,384,0.06676602363586426
308,320,110,134,0,0.45500001311302185,308.0,387,253,320.0,253,253,253,387,363,253,363,387,0.06792688369750977
303,323,108,136,0,0.45500001311302185,303.0,391,249,323.0,249,255,249,391,357,255,357,391,0.06551098823547363
297,325,110,136,0,0.44200003147125244,297.0,393,242,325.0,242,257,242,393,352,257,352,393,0.06656050682067871
292,327,110,135,0,0.44300001859664917,292.0,395,237,327.5,237,260,237,395,347,260,347,395,0.06655335426330566
287,329,110,135,0,0.4400000274181366,287.0,397,232,329.5,232,262,232,397,342,262,342,397,0.06825613975524902
282,332,111,134,0,0.4400000274181366,282.5,399,227,332.0,227,265,227,399,338,265,338,399,0.06474971771240234
278,334,111,136,0,0.4410000145435333,278.5,402,223,334.0,223,266,223,402,334,266,334,402,0.0667421817779541
275,336,111,136,0,0.44300001859664917,275.5,404,220,336.0,220,268,220,404,331,268,331,404,0.06650471687316895
273,338,112,136,0,0.445000022649765,273.0,406,217,338.0,217,270,217,406,329,270,329,406,0.06682515144348145
269,339,111,136,0,0.4390000104904175,269.5,407,214,339.0,214,271,214,407,325,271,325,407,0.06627917289733887
267,340,112,136,0,0.4410000145435333,267.0,408,211,340.0,211,272,211,408,323,272,323,408,0.06641793251037598
265,341,112,138,0,0.44200003147125244,265.0,410,209,341.0,209,272,209,410,321,272,321,410,0.06718707084655762
264,342,112,138,0,0.4440000355243683,264.0,411,208,342.0,208,273,208,411,320,273,320,411,0.06606054306030273
263,342,112,138,0,0.44200003147125244,263.0,411,207,342.0,207,273,207,411,319,273,319,411,0.06719350814819336
262,342,112,138,0,0.44200003147125244,262.0,411,206,342.0,206,273,206,411,318,273,318,411,0.0667409896850586
262,342,112,138,0,0.44300001859664917,262.0,411,206,342.0,206,273,206,411,318,273,318,411,0.06651067733764648
262,341,112,137,0,0.4400000274181366,262.0,410,206,341.5,206,273,206,410,318,273,318,410,0.06698226928710938
262,341,112,138,0,0.4410000145435333,262.0,410,206,341.0,206,272,206,410,318,272,318,410,0.06620669364929199
262,341,113,137,0,0.4400000274181366,262.5,410,206,341.5,206,273,206,410,319,273,319,410,0.06711602210998535
263,341,114,138,0,0.4410000145435333,263.0,410,206,341.0,206,272,206,410,320,272,320,410,0.06651759147644043
263,340,113,139,0,0.4360000193119049,263.5,410,207,340.5,207,271,207,410,320,271,320,410,0.06621599197387695
264,339,114,139,0,0.43300002813339233,264.0,409,207,339.5,207,270,207,409,321,270,321,409,0.06662917137145996
264,338,113,139,0,0.4300000071525574,264.5,408,208,338.5,208,269,208,408,321,269,321,408,0.06641912460327148
265,337,114,141,0,0.4270000159740448,265.0,408,208,337.5,208,267,208,408,322,267,322,408,0.06733107566833496
265,336,115,141,0,0.42500001192092896,265.5,407,208,336.5,208,266,208,407,323,266,323,407,0.06597638130187988
266,336,116,146,0,0.4240000247955322,266.0,409,208,336.0,208,263,208,409,324,263,324,409,0.06674909591674805
267,333,116,145,0,0.4140000343322754,267.0,406,209,333.5,209,261,209,406,325,261,325,406,0.0668337345123291
268,330,118,145,0,0.4090000092983246,268.0,403,209,330.5,209,258,209,403,327,258,327,403,0.06598830223083496
269,328,118,145,0,0.40700000524520874,269.0,401,210,328.5,210,256,210,401,328,256,328,401,0.06792926788330078
270,326,120,146,0,0.3970000147819519,270.0,399,210,326.0,210,253,210,399,330,253,330,399,0.06594181060791016
270,322,121,147,0,0.3880000114440918,270.5,396,210,322.5,210,249,210,396,331,249,331,396,0.06598091125488281
271,319,121,149,0,0.3800000250339508,271.5,394,211,319.5,211,245,211,394,332,245,332,394,0.06730866432189941
272,316,123,151,0,0.37700000405311584,272.5,392,211,316.5,211,241,211,392,334,241,334,392,0.06612229347229004
273,316,124,159,0,0.37700000405311584,273.0,396,211,316.5,211,237,211,396,335,237,335,396,0.06739377975463867
273,310,125,155,0,0.36500000953674316,273.5,388,211,310.5,211,233,211,388,336,233,336,388,0.066925048828125
275,305,126,156,0,0.3580000102519989,275.0,383,212,305.0,212,227,212,383,338,227,338,383,0.06573295593261719
275,300,127,157,0,0.3450000286102295,275.5,379,212,300.5,212,222,212,379,339,222,339,379,0.06726813316345215
277,295,130,161,0,0.0,277.0,376,212,295.5,212,215,212,376,342,215,342,376,0.06574606895446777
277,290,131,162,0,0.3290000259876251,277.5,371,212,290.0,212,209,212,371,343,209,343,371,0.06679058074951172
277,285,133,164,0,0.32500001788139343,277.5,367,211,285.0,211,203,211,367,344,203,344,367,0.06732511520385742
278,283,135,173,0,0.32200002670288086,278.5,370,211,283.5,211,197,211,370,346,197,346,370,0.0655059814453125
279,277,136,170,0,0.3150000274181366,279.0,362,211,277.0,211,192,211,362,347,192,347,362,0.06945633888244629
279,271,137,170,0,0.0,279.5,356,211,271.0,211,186,211,356,348,186,348,356,0.06437802314758301
279,266,139,172,0,0.0,279.5,352,210,266.0,210,180,210,352,349,180,349,352,0.06628727912902832
279,263,140,174,0,0.0,279.0,350,209,263.0,209,176,209,350,349,176,349,350,0.06672430038452148
279,258,141,176,0,0.0,279.5,346,209,258.0,209,170,209,346,350,170,350,346,0.06664609909057617
280,254,142,177,0,0.0,280.0,343,209,254.5,209,166,209,343,351,166,351,343,0.06679415702819824
279,250,143,178,0,0.0,279.5,339,208,250.0,208,161,208,339,351,161,351,339,0.06642866134643555
280,247,144,180,0,0.0,280.0,337,208,247.0,208,157,208,337,352,157,352,337,0.06664586067199707
279,244,145,183,0,0.0,279.5,336,207,244.5,207,153,207,336,352,153,352,336,0.06626725196838379
279,241,147,183,0,0.3620000183582306,279.5,333,206,241.5,206,150,206,333,353,150,353,333,0.0663144588470459
279,238,148,183,0,0.0,279.0,330,205,238.5,205,147,205,330,353,147,353,330,0.0673666000366211
279,236,148,184,0,0.0,279.0,328,205,236.0,205,144,205,328,353,144,353,328,0.06635522842407227
278,234,149,184,0,0.3500000238418579,278.5,326,204,234.0,204,142,204,326,353,142,353,326,0.06642413139343262
279,233,148,185,0,0.3540000021457672,279.0,326,205,233.5,205,141,205,326,353,141,353,326,0.06705808639526367
279,231,150,185,0,0.35500001907348633,279.0,324,204,231.5,204,139,204,324,354,139,354,324,0.06631588935852051
279,230,150,186,0,0.3530000150203705,279.0,323,204,230.0,204,137,204,323,354,137,354,323,0.06664609909057617
279,230,150,186,0,0.3530000150203705,279.0,323,204,230.0,204,137,204,323,354,137,354,323,0.06759095191955566
279,230,150,186,0,0.3500000238418579,279.0,323,204,230.0,204,137,204,323,354,137,354,323,0.06525802612304688
279,230,150,186,0,0.3540000021457672,279.0,323,204,230.0,204,137,204,323,354,137,354,323,0.06732749938964844
278,229,150,187,0,0.3490000069141388,278.0,323,203,229.5,203,136,203,323,353,136,353,323,0.0658266544342041
277,229,150,187,0,0.3490000069141388,277.0,323,202,229.5,202,136,202,323,352,136,352,323,0.06726455688476562
275,230,150,188,0,0.3410000205039978,275.0,324,200,230.0,200,136,200,324,350,136,350,324,0.06664490699768066
272,230,151,188,0,0.0,272.5,324,197,230.0,197,136,197,324,348,136,348,324,0.06689906120300293
269,234,152,197,0,0.0,269.0,333,193,234.5,193,136,193,333,345,136,345,333,0.06660318374633789
265,233,152,193,0,0.0,265.0,330,189,233.5,189,137,189,330,341,137,341,330,0.06649160385131836
260,231,153,190,0,0.3330000042915344,260.5,326,184,231.0,184,136,184,326,337,136,337,326,0.06598448753356934
254,231,153,189,0,0.33400002121925354,254.5,326,178,231.5,178,137,178,326,331,137,331,326,0.06709933280944824
248,232,154,190,0,0.33500000834465027,248.0,327,171,232.0,171,137,171,327,325,137,325,327,0.06623291969299316
241,233,155,190,0,0.0,241.5,328,164,233.0,164,138,164,328,319,138,319,328,0.06663203239440918
233,233,157,191,0,0.0,233.5,329,155,233.5,155,138,155,329,312,138,312,329,0.06757330894470215
225,234,157,192,0,0.3290000259876251,225.5,330,147,234.0,147,138,147,330,304,138,304,330,0.06569123268127441
216,235,158,192,0,0.0,216.0,331,137,235.0,137,139,137,331,295,139,295,331,0.06963205337524414
206,236,160,193,0,0.0,206.0,333,126,236.5,126,140,126,333,286,140,286,333,0.06323122978210449
195,238,163,195,0,0.0,195.5,336,114,238.5,114,141,114,336,277,141,277,336,0.06682276725769043
184,239,164,195,0,0.0,184.0,337,102,239.5,102,142,102,337,266,142,266,337,0.06682777404785156
174,240,164,196,0,0.0,174.0,338,92,240.0,92,142,92,338,256,142,256,338,0.06618523597717285
164,240,165,195,0,0.0,164.5,338,82,240.5,82,143,82,338,247,143,247,338,0.06773233413696289
155,242,167,198,0,0.0,155.5,341,72,242.0,72,143,72,341,239,143,239,341,0.06573653221130371
147,242,167,197,0,0.0,147.5,341,64,242.5,64,144,64,341,231,144,231,341,0.06651997566223145
140,243,168,198,0,0.0,140.0,342,56,243.0,56,144,56,342,224,144,224,342,0.06717324256896973
133,243,168,198,0,0.0,133.0,342,49,243.0,49,144,49,342,217,144,217,342,0.06571269035339355
127,244,170,198,0,0.0,127.0,343,42,244.0,42,145,42,343,212,145,212,343,0.06798291206359863
122,244,170,198,0,0.0,122.0,343,37,244.0,37,145,37,343,207,145,207,343,0.0654764175415039
117,244,170,199,0,0.0,117.0,344,32,244.5,32,145,32,344,202,145,202,344,0.06706762313842773
113,245,171,200,0,0.0,113.5,345,28,245.0,28,145,28,345,199,145,199,345,0.06602597236633301
110,246,171,202,0,0.0,110.5,347,25,246.0,25,145,25,347,196,145,196,347,0.06655097007751465
108,245,171,201,0,0.0,108.5,346,23,245.5,23,145,23,346,194,145,194,346,0.06794595718383789
106,247,171,203,0,0.0,106.5,349,21,247.5,21,146,21,349,192,146,192,349,0.06589436531066895
106,249,171,206,0,0.0,106.5,352,21,249.0,21,146,21,352,192,146,192,352,0.06656503677368164
106,248,171,204,0,0.0,106.5,350,21,248.0,21,146,21,350,192,146,192,350,0.06639432907104492
107,246,171,200,0,0.0,107.5,346,22,246.0,22,146,22,346,193,146,193,346,0.06644272804260254
109,246,172,199,0,0.0,109.0,346,23,246.5,23,147,23,346,195,147,195,346,0.06731319427490234
111,248,172,200,0,0.0,111.0,348,25,248.0,25,148,25,348,197,148,197,348,0.0660712718963623
114,254,172,209,0,0.0,114.0,359,28,254.5,28,150,28,359,200,150,200,359,0.06654047966003418
117,255,172,207,0,0.0,117.0,359,31,255.5,31,152,31,359,203,152,203,359,0.06690478324890137
121,258,172,206,0,0.0,121.0,361,35,258.0,35,155,35,361,207,155,207,361,0.06602287292480469
126,265,171,217,0,0.0,126.5,374,41,265.5,41,157,41,374,212,157,212,374,0.06747841835021973
131,264,173,208,0,0.0,131.5,368,45,264.0,45,160,45,368,218,160,218,368,0.06577205657958984
138,266,173,205,0,0.0,138.5,369,52,266.5,52,164,52,369,225,164,225,369,0.06688380241394043
146,269,172,203,0,0.0,146.0,371,60,269.5,60,168,60,371,232,168,232,371,0.06699538230895996
154,272,173,203,0,0.0,154.5,374,68,272.5,68,171,68,374,241,171,241,374,0.0673666000366211
163,277,175,202,0,0.0,163.5,378,76,277.0,76,176,76,378,251,176,251,378,0.0666494369506836
174,283,174,202,0,0.2550000250339508,174.0,384,87,283.0,87,182,87,384,261,182,261,384,0.06581234931945801
185,288,174,202,0,0.2510000169277191,185.0,389,98,288.0,98,187,98,389,272,187,272,389,0.06609630584716797
196,295,175,205,0,0.25200000405311584,196.5,398,109,295.5,109,193,109,398,284,193,284,398,0.06789016723632812
210,300,175,205,0,0.24900001287460327,210.5,403,123,300.5,123,198,123,403,298,198,298,403,0.06534123420715332
225,306,177,207,0,0.2460000067949295,225.5,410,137,306.5,137,203,137,410,314,203,314,410,0.06742596626281738
241,312,178,207,0,0.2460000067949295,241.0,416,152,312.5,152,209,152,416,330,209,330,416,0.06596231460571289
258,320,178,207,0,0.2410000115633011,258.0,424,169,320.5,169,217,169,424,347,217,347,424,0.06711292266845703
277,327,182,211,0,0.2510000169277191,277.0,433,186,327.5,186,222,186,433,368,222,368,433,0.06639671325683594
297,334,182,212,0,0.0,297.0,440,206,334.0,206,228,206,440,388,228,388,440,0.06646919250488281
316,341,184,213,0,0.0,316.0,448,224,341.5,224,235,224,448,408,235,408,448,0.06694746017456055
334,348,184,214,0,0.3140000104904175,334.0,455,242,348.0,242,241,242,455,426,241,426,455,0.06690359115600586
351,352,187,215,0,0.31300002336502075,351.5,460,258,352.5,258,245,258,460,445,245,445,460,0.06609630584716797
368,358,189,214,0,0.3110000193119049,368.5,465,274,358.0,274,251,274,465,463,251,463,465,0.06939339637756348
385,363,189,217,0,0.30900001525878906,385.5,472,291,363.5,291,255,291,472,480,255,480,472,0.06336307525634766
402,368,194,218,0,0.3100000023841858,402.0,477,305,368.0,305,259,305,477,499,259,499,477,0.06658077239990234
415,371,196,217,0,0.30900001525878906,415.0,480,317,371.5,317,263,317,480,513,263,513,480,0.0666651725769043
427,373,200,213,0,0.30800002813339233,427.0,480,327,373.5,327,267,327,480,527,267,527,480,0.06661725044250488
439,374,205,211,0,0.30800002813339233,439.5,480,337,374.5,337,269,337,480,542,269,542,480,0.06700921058654785
449,376,207,208,0,0.30800002813339233,449.5,480,346,376.0,346,272,346,480,553,272,553,480,0.06601190567016602
460,377,210,206,0,0.30800002813339233,460.0,480,355,377.0,355,274,355,480,565,274,565,480,0.06717777252197266
469,377,213,203,0,0.30800002813339233,469.5,479,363,377.5,363,276,363,479,576,276,576,479,0.06682777404785156
477,379,216,201,0,0.3070000112056732,477.0,480,369,379.5,369,279,369,480,585,279,585,480,0.0661153793334961
483,379,219,199,0,0.3070000112056732,483.5,479,374,379.5,374,280,374,479,593,280,593,479,0.06728696823120117
488,380,222,198,0,0.3070000112056732,488.0,479,377,380.0,377,281,377,479,599,281,599,479,0.06629204750061035
493,380,222,197,0,0.3060000240802765,493.0,479,382,380.5,382,282,382,479,604,282,604,479,0.06749224662780762
497,381,225,196,0,0.3060000240802765,497.5,479,385,381.0,385,283,385,479,610,283,610,479,0.06567811965942383
499,381,228,195,0,0.3070000112056732,499.0,479,385,381.5,385,284,385,479,613,284,613,479,0.06681108474731445
500,382,229,194,0,0.3070000112056732,500.5,479,386,382.0,386,285,386,479,615,285,615,479,0.06644058227539062
499,382,229,194,0,0.3060000240802765,499.5,479,385,382.0,385,285,385,479,614,285,614,479,0.06677770614624023
499,382,230,194,0,0.3060000240802765,499.0,479,384,382.0,384,285,384,479,614,285,614,479,0.0665140151977539
498,381,230,195,0,0.3060000240802765,498.0,479,383,381.5,383,284,383,479,613,284,613,479,0.06671357154846191
496,381,227,196,0,0.3060000240802765,496.5,479,383,381.0,383,283,383,479,610,283,610,479,0.06642270088195801
494,380,224,198,0,0.3060000240802765,494.0,479,382,380.0,382,281,382,479,606,281,606,479,0.06687283515930176
490,380,222,198,0,0.3060000240802765,490.0,479,379,380.0,379,281,379,479,601,281,601,479,0.06625771522521973
485,378,221,201,0,0.3070000112056732,485.5,479,375,378.5,375,278,375,479,596,278,596,479,0.06720900535583496
481,378,218,202,0,0.3070000112056732,481.0,479,372,378.0,372,277,372,479,590,277,590,479,0.06566667556762695
475,376,216,206,0,0.30800002813339233,475.0,479,367,376.0,367,273,367,479,583,273,583,479,0.06676697731018066
468,374,215,209,0,0.3070000112056732,468.5,479,361,374.5,361,270,361,479,576,270,576,479,0.06638455390930176
460,373,212,211,0,0.3070000112056732,460.0,479,354,373.5,354,268,354,479,566,268,566,479,0.06702089309692383
452,371,210,215,0,0.3060000240802765,452.0,479,347,371.5,347,264,347,479,557,264,557,479,0.0661933422088623
443,369,208,217,0,0.3070000112056732,443.0,478,339,369.5,339,261,339,478,547,261,547,478,0.06686663627624512
432,366,203,221,0,0.3060000240802765,432.5,477,331,366.5,331,256,331,477,534,256,534,477,0.06607460975646973
422,363,201,223,0,0.30800002813339233,422.5,475,322,363.5,322,252,322,475,523,252,523,475,0.06699633598327637
411,359,199,224,0,0.30900001525878906,411.5,471,312,359.0,312,247,312,471,511,247,511,471,0.06752800941467285
400,351,194,220,0,0.30900001525878906,400.0,461,303,351.0,303,241,303,461,497,241,497,461,0.06556081771850586
386,344,191,218,0,0.31200000643730164,386.5,453,291,344.0,291,235,291,453,482,235,482,453,0.0668325424194336
372,337,189,217,0,0.31200000643730164,372.5,446,278,337.5,278,229,278,446,467,229,467,446,0.06811380386352539
358,330,187,216,0,0.3140000104904175,358.5,438,265,330.0,265,222,265,438,452,222,452,438,0.06651067733764648
342,322,185,215,0,0.0,342.5,430,250,322.5,250,215,250,430,435,215,435,430,0.0657649040222168
326,315,185,216,0,0.0,326.5,423,234,315.0,234,207,234,423,419,207,419,423,0.06743216514587402
311,306,185,215,0,0.0,311.5,414,219,306.5,219,199,219,414,404,199,404,414,0.06610918045043945
296,299,183,213,0,0.0,296.5,406,205,299.5,205,193,205,406,388,193,388,406,0.06560826301574707
284,294,182,214,0,0.0,284.0,401,193,294.0,193,187,193,401,375,187,375,401,0.06637382507324219
271,286,182,214,0,0.0,271.0,393,180,286.0,180,179,180,393,362,179,362,393,0.0671684741973877
260,279,182,213,0,0.0,260.0,386,169,279.5,169,173,169,386,351,173,351,386,0.06641674041748047
248,272,181,212,0,0.0,248.5,378,158,272.0,158,166,158,378,339,166,339,378,0.06645846366882324
239,268,180,212,0,0.0,239.0,374,149,268.0,149,162,149,374,329,162,329,374,0.06689667701721191
230,262,180,213,0,0.0,230.0,369,140,262.5,140,156,140,369,320,156,320,369,0.06591105461120605
222,257,179,213,0,0.0,222.5,364,133,257.5,133,151,133,364,312,151,312,364,0.0671243667602539
214,253,179,215,0,0.0,214.5,361,125,253.5,125,146,125,361,304,146,304,361,0.06581950187683105
207,249,178,215,0,0.0,207.0,357,118,249.5,118,142,118,357,296,142,296,357,0.06722664833068848
201,244,178,213,0,0.0,201.0,351,112,244.5,112,138,112,351,290,138,290,351,0.06712675094604492
195,240,179,210,0,0.0,195.5,345,106,240.0,106,135,106,345,285,135,285,345,0.06602168083190918
191,238,178,213,0,0.0,191.0,345,102,238.5,102,132,102,345,280,132,280,345,0.06661844253540039
187,236,178,215,0,0.2900000214576721,187.0,344,98,236.5,98,129,98,344,276,129,276,344,0.06722187995910645
183,233,179,212,0,0.289000004529953,183.5,339,94,233.0,94,127,94,339,273,127,273,339,0.06692743301391602
180,233,178,217,0,0.2939999997615814,180.0,342,91,233.5,91,125,91,342,269,125,269,342,0.06687164306640625
178,230,178,215,0,0.29200002551078796,178.0,338,89,230.5,89,123,89,338,267,123,267,338,0.06525802612304688
176,229,179,215,0,0.29200002551078796,176.5,337,87,229.5,87,122,87,337,266,122,266,337,0.06678605079650879
175,229,179,216,0,0.2970000207424164,175.5,337,86,229.0,86,121,86,337,265,121,265,337,0.06632065773010254
176,228,178,215,0,0.2930000126361847,176.0,336,87,228.5,87,121,87,336,265,121,265,336,0.06703782081604004
175,228,179,215,0,0.29600000381469727,175.5,336,86,228.5,86,121,86,336,265,121,265,336,0.06610941886901855
176,229,178,214,0,0.29500001668930054,176.0,336,87,229.0,87,122,87,336,265,122,265,336,0.06662583351135254
176,230,178,217,0,0.29200002551078796,176.0,339,87,230.5,87,122,87,339,265,122,265,339,0.06704831123352051
176,231,178,214,0,0.2939999997615814,176.0,338,87,231.0,87,124,87,338,265,124,265,338,0.06600832939147949
177,233,177,215,0,0.2880000174045563,177.5,341,89,233.5,89,126,89,341,266,126,266,341,0.06726813316345215
178,234,176,213,0,0.289000004529953,178.0,341,90,234.5,90,128,90,341,266,128,266,341,0.06614851951599121
179,236,175,211,0,0.29200002551078796,179.5,342,92,236.5,92,131,92,342,267,131,267,342,0.06750082969665527
181,238,174,209,0,0.0,181.0,343,94,238.5,94,134,94,343,268,134,268,343,0.0662541389465332
182,241,172,206,0,0.0,182.0,344,96,241.0,96,138,96,344,268,138,268,344,0.0660393238067627
184,244,172,204,0,0.3070000112056732,184.0,346,98,244.0,98,142,98,346,270,142,270,346,0.06681704521179199
185,248,171,205,0,0.0,185.5,351,100,248.5,100,146,100,351,271,146,271,351,0.06651759147644043
187,257,170,213,0,0.26100000739097595,187.0,364,102,257.5,102,151,102,364,272,151,272,364,0.06656193733215332
188,265,169,219,0,0.26100000739097595,188.5,375,104,265.5,104,156,104,375,273,156,273,375,0.06662487983703613
190,266,167,209,0,0.2639999985694885,190.5,371,107,266.5,107,162,107,371,274,162,274,371,0.06655597686767578
192,266,165,201,0,0.0,192.5,367,110,266.5,110,166,110,367,275,166,275,367,0.06683707237243652
195,271,163,197,0,0.0,195.5,370,114,271.5,114,173,114,370,277,173,277,370,0.06685495376586914
197,275,162,193,0,0.27300000190734863,197.0,372,116,275.5,116,179,116,372,278,179,278,372,0.06617331504821777
199,280,160,190,0,0.2760000228881836,199.0,375,119,280.0,119,185,119,375,279,185,279,375,0.06722521781921387
201,285,158,187,0,0.2760000228881836,201.0,379,122,285.5,122,192,122,379,280,192,280,379,0.0659630298614502
203,291,155,186,0,0.28600001335144043,203.5,384,126,291.0,126,198,126,384,281,198,281,384,0.06708741188049316
205,295,153,182,0,0.0,205.5,386,129,295.0,129,204,129,386,282,204,282,386,0.06654024124145508
206,300,151,181,0,0.0,206.5,391,131,300.5,131,210,131,391,282,210,282,391,0.06603693962097168
209,306,148,177,0,0.3110000193119049,209.0,395,135,306.5,135,218,135,395,283,218,283,395,0.06710648536682129
210,312,145,177,0,0.0,210.5,401,138,312.5,138,224,138,401,283,224,283,401,0.0662539005279541
212,316,142,173,0,0.0,212.0,403,141,316.5,141,230,141,403,283,230,283,403,0.06730484962463379
213,323,141,176,0,0.0,213.5,411,143,323.0,143,235,143,411,284,235,284,411,0.06576752662658691
215,324,139,169,0,0.0,215.5,409,146,324.5,146,240,146,409,285,240,285,409,0.06595730781555176
216,327,137,166,0,0.0,216.5,410,148,327.0,148,244,148,410,285,244,285,410,0.06764793395996094
217,330,137,163,0,0.0,217.5,412,149,330.5,149,249,149,412,286,249,286,412,0.06627202033996582
217,333,135,161,0,0.3880000114440918,217.5,414,150,333.5,150,253,150,414,285,253,285,414,0.06616973876953125
219,336,134,160,0,0.3930000066757202,219.0,416,152,336.0,152,256,152,416,286,256,286,416,0.06721949577331543
219,337,133,157,0,0.3930000066757202,219.5,416,153,337.5,153,259,153,416,286,259,286,416,0.0660865306854248
220,340,132,157,0,0.3960000276565552,220.0,419,154,340.5,154,262,154,419,286,262,286,419,0.06645607948303223
220,342,130,156,0,0.398000031709671,220.0,420,155,342.0,155,264,155,420,285,264,285,420,0.06700682640075684
219,344,129,156,0,0.40400001406669617,219.5,422,155,344.0,155,266,155,422,284,266,284,422,0.06593608856201172
220,346,128,154,0,0.40400001406669617,220.0,423,156,346.0,156,269,156,423,284,269,284,423,0.06756854057312012
220,346,128,153,0,0.406000018119812,220.0,423,156,346.5,156,270,156,423,284,270,284,423,0.06576395034790039
220,347,127,152,0,0.40800002217292786,220.5,423,157,347.0,157,271,157,423,284,271,284,423,0.06650114059448242
220,348,127,151,0,0.4100000262260437,220.5,424,157,348.5,157,273,157,424,284,273,284,424,0.06734061241149902
221,349,126,150,0,0.4100000262260437,221.0,424,158,349.0,158,274,158,424,284,274,284,424,0.06569838523864746
221,349,126,151,0,0.41100001335144043,221.0,425,158,349.5,158,274,158,425,284,274,284,425,0.06709480285644531
221,350,126,150,0,0.41100001335144043,221.0,425,158,350.0,158,275,158,425,284,275,284,425,0.0665745735168457
221,350,125,149,0,0.4140000343322754,221.5,425,159,350.5,159,276,159,425,284,276,284,425,0.0664668083190918
221,350,125,149,0,0.4130000174045563,221.5,425,159,350.5,159,276,159,425,284,276,284,425,0.06668400764465332
221,350,125,149,0,0.4140000343322754,221.5,425,159,350.5,159,276,159,425,284,276,284,425,0.06738924980163574
221,350,125,149,0,0.4140000343322754,221.5,425,159,350.5,159,276,159,425,284,276,284,425,0.06623411178588867
222,350,125,149,0,0.4140000343322754,222.5,425,160,350.5,160,276,160,425,285,276,285,425,0.06629467010498047
224,351,125,148,0,0.4140000343322754,224.5,425,162,351.0,162,277,162,425,287,277,287,425,0.06644177436828613
226,351,125,149,0,0.4150000214576721,226.5,426,164,351.5,164,277,164,426,289,277,289,426,0.06633377075195312
229,352,125,150,0,0.4150000214576721,229.5,427,167,352.0,167,277,167,427,292,277,292,427,0.06628966331481934
232,352,125,148,0,0.4140000343322754,232.5,426,170,352.0,170,278,170,426,295,278,295,426,0.0671231746673584
237,352,124,148,0,0.41200003027915955,237.0,426,175,352.0,175,278,175,426,299,278,299,426,0.0664820671081543
242,351,124,147,0,0.4130000174045563,242.0,425,180,351.5,180,278,180,425,304,278,304,425,0.06747245788574219
248,352,124,148,0,0.4140000343322754,248.0,426,186,352.0,186,278,186,426,310,278,310,426,0.06627655029296875
255,353,124,148,0,0.4100000262260437,255.0,427,193,353.0,193,279,193,427,317,279,317,427,0.06664347648620605
262,353,124,146,0,0.4100000262260437,262.0,426,200,353.0,200,280,200,426,324,280,324,426,0.0662078857421875
270,354,123,148,0,0.41200003027915955,270.5,428,209,354.0,209,280,209,428,332,280,332,428,0.06752467155456543
278,354,121,147,0,0.4140000343322754,278.5,428,218,354.5,218,281,218,428,339,281,339,428,0.06701064109802246
288,354,122,147,0,0.42000001668930054,288.0,428,227,354.5,227,281,227,428,349,281,349,428,0.06647396087646484
298,355,123,147,0,0.4230000078678131,298.5,429,237,355.5,237,282,237,429,360,282,360,429,0.06628251075744629
309,356,122,147,0,0.42600002884864807,309.0,430,248,356.5,248,283,248,430,370,283,370,430,0.0657651424407959
321,356,122,146,0,0.42900002002716064,321.0,429,260,356.0,260,283,260,429,382,283,382,429,0.06883883476257324
333,357,123,146,0,0.4280000329017639,333.5,430,272,357.0,272,284,272,430,395,284,395,430,0.0649869441986084
345,356,123,146,0,0.4270000159740448,345.5,429,284,356.0,284,283,284,429,407,283,407,429,0.0677490234375
358,357,124,146,0,0.4280000329017639,358.0,430,296,357.0,296,284,296,430,420,284,420,430,0.06496143341064453
369,357,123,145,0,0.4310000240802765,369.5,430,308,357.5,308,285,308,430,431,285,431,430,0.06651878356933594
380,357,123,145,0,0.4320000112056732,380.5,430,319,357.5,319,285,319,430,442,285,442,430,0.06674313545227051
390,357,126,144,0,0.43400001525878906,390.0,429,327,357.0,327,285,327,429,453,285,453,429,0.06695818901062012
399,357,126,143,0,0.4350000321865082,399.0,429,336,357.5,336,286,336,429,462,286,462,429,0.06638479232788086
407,357,127,143,0,0.4400000274181366,407.5,429,344,357.5,344,286,344,429,471,286,471,429,0.06601548194885254
414,357,128,143,0,0.4440000355243683,414.0,429,350,357.5,350,286,350,429,478,286,478,429,0.06746530532836914
420,357,129,143,0,0.4440000355243683,420.5,429,356,357.5,356,286,356,429,485,286,485,429,0.06661868095397949
427,357,130,143,0,0.44700002670288086,427.0,429,362,357.5,362,286,362,429,492,286,492,429,0.0662839412689209
433,357,130,143,0,0.4480000138282776,433.0,429,368,357.5,368,286,368,429,498,286,498,429,0.06778693199157715
437,357,131,142,0,0.4520000219345093,437.5,428,372,357.0,372,286,372,428,503,286,503,428,0.06623172760009766
442,357,132,142,0,0.453000009059906,442.0,428,376,357.0,376,286,376,428,508,286,508,428,0.06586217880249023
445,357,132,142,0,0.4520000219345093,445.0,428,379,357.0,379,286,379,428,511,286,511,428,0.06756734848022461
448,356,132,141,0,0.453000009059906,448.0,427,382,356.5,382,286,382,427,514,286,514,427,0.06669950485229492
450,356,133,141,0,0.4540000259876251,450.5,427,384,356.5,384,286,384,427,517,286,517,427,0.06701970100402832
451,356,133,141,0,0.45500001311302185,451.5,427,385,356.5,385,286,385,427,518,286,518,427,0.06639409065246582
452,356,133,141,0,0.45600003004074097,452.5,427,386,356.5,386,286,386,427,519,286,519,427,0.06579208374023438
452,356,133,141,0,0.4540000259876251,452.5,427,386,356.5,386,286,386,427,519,286,519,427,0.06789016723632812
452,356,133,141,0,0.45600003004074097,452.5,427,386,356.5,386,286,386,427,519,286,519,427,0.06562137603759766
453,356,133,141,0,0.4540000259876251,453.5,427,387,356.5,387,286,387,427,520,286,520,427,0.06739377975463867
453,356,133,141,0,0.4540000259876251,453.5,427,387,356.5,387,286,387,427,520,286,520,427,0.06641554832458496
454,356,133,142,0,0.453000009059906,454.5,427,388,356.0,388,285,388,427,521,285,521,427,0.0664205551147461
455,355,134,142,0,0.4520000219345093,455.0,426,388,355.0,388,284,388,426,522,284,522,426,0.06670546531677246
456,354,135,143,0,0.453000009059906,456.5,426,389,354.5,389,283,389,426,524,283,524,426,0.06577658653259277
457,353,136,145,0,0.4480000138282776,457.0,426,389,353.5,389,281,389,426,525,281,525,426,0.06698894500732422
459,352,136,145,0,0.4520000219345093,459.0,425,391,352.5,391,280,391,425,527,280,527,425,0.06705212593078613
460,351,137,147,0,0.4480000138282776,460.5,425,392,351.5,392,278,392,425,529,278,529,425,0.06591582298278809
462,350,139,147,0,0.445000022649765,462.5,424,393,350.5,393,277,393,424,532,277,532,424,0.06744050979614258
465,349,140,150,0,0.4440000355243683,465.0,424,395,349.0,395,274,395,424,535,274,535,424,0.06579709053039551
466,347,141,149,0,0.44200003147125244,466.5,422,396,347.5,396,273,396,422,537,273,537,422,0.0669560432434082
469,346,143,150,0,0.4390000104904175,469.5,421,398,346.0,398,271,398,421,541,271,541,421,0.06678128242492676
471,343,143,152,0,0.43800002336502075,471.5,419,400,343.0,400,267,400,419,543,267,543,419,0.0663299560546875
474,341,145,154,0,0.4360000193119049,474.5,418,402,341.0,402,264,402,418,547,264,547,418,0.06727147102355957
477,340,146,158,0,0.43400001525878906,477.0,419,404,340.0,404,261,404,419,550,261,550,419,0.06618070602416992
480,336,150,159,0,0.43300002813339233,480.0,416,405,336.5,405,257,405,416,555,257,555,416,0.0670318603515625
483,339,152,173,0,0.4240000247955322,483.0,426,407,339.5,407,253,407,426,559,253,559,426,0.0666046142578125
486,337,154,178,0,0.42100003361701965,486.0,426,409,337.0,409,248,409,426,563,248,563,426,0.06582784652709961
490,328,158,168,0,0.4220000207424164,490.0,412,411,328.0,411,244,411,412,569,244,569,412,0.06896805763244629
494,321,160,167,0,0.42100003361701965,494.0,405,414,321.5,414,238,414,405,574,238,574,405,0.06467866897583008
497,318,162,169,0,0.4180000126361847,497.0,403,416,318.5,416,234,416,403,578,234,578,403,0.06682777404785156
500,314,164,171,0,0.41600000858306885,500.0,400,418,314.5,418,229,418,400,582,229,582,400,0.06666254997253418
503,312,168,175,0,0.4140000343322754,503.0,400,419,312.5,419,225,419,400,587,225,587,400,0.06705451011657715
506,313,170,187,0,0.40700000524520874,506.0,407,421,313.5,421,220,421,407,591,220,591,407,0.06582999229431152
508,307,171,184,0,0.4090000092983246,508.5,399,423,307.0,423,215,423,399,594,215,594,399,0.06657576560974121
511,304,172,187,0,0.40800002217292786,511.0,398,425,304.5,425,211,425,398,597,211,597,398,0.06666040420532227
513,300,174,187,0,0.4050000309944153,513.0,394,426,300.5,426,207,426,394,600,207,600,394,0.06647372245788574
515,299,176,190,0,0.40400001406669617,515.0,394,427,299.0,427,204,427,394,603,204,603,394,0.06651186943054199
516,294,179,186,0,0.40400001406669617,516.5,387,427,294.0,427,201,427,387,606,201,606,387,0.06677770614624023
518,287,180,181,0,0.406000018119812,518.0,378,428,287.5,428,197,428,378,608,197,608,378,0.06628990173339844
519,286,181,183,0,0.4050000309944153,519.5,378,429,286.5,429,195,429,378,610,195,610,378,0.06646203994750977
521,285,182,186,0,0.40400001406669617,521.0,378,430,285.0,430,192,430,378,612,192,612,378,0.0665428638458252
521,284,183,188,0,0.4020000100135803,521.5,378,430,284.0,430,190,430,378,613,190,613,378,0.06672525405883789
523,281,184,189,0,0.4010000228881836,523.0,376,431,281.5,431,187,431,376,615,187,615,376,0.06732654571533203
524,279,184,189,0,0.40300002694129944,524.0,374,432,279.5,432,185,432,374,616,185,616,374,0.06598949432373047
524,278,185,188,0,0.4010000228881836,524.5,372,432,278.0,432,184,432,372,617,184,617,372,0.06646561622619629
524,277,185,188,0,0.4010000228881836,524.5,371,432,277.0,432,183,432,371,617,183,617,371,0.06651782989501953
525,277,186,188,0,0.4020000100135803,525.0,371,432,277.0,432,183,432,371,618,183,618,371,0.06623506546020508
525,277,185,188,0,0.39900001883506775,525.5,371,433,277.0,433,183,433,371,618,183,618,371,0.06687760353088379
525,277,186,188,0,0.4000000059604645,525.0,371,432,277.0,432,183,432,371,618,183,618,371,0.06691908836364746
524,277,186,188,0,0.4010000228881836,524.0,371,431,277.0,431,183,431,371,617,183,617,371,0.06711387634277344
523,277,186,189,0,0.4000000059604645,523.0,372,430,277.5,430,183,430,372,616,183,616,372,0.06601071357727051
521,277,187,189,0,0.4010000228881836,521.5,372,428,277.5,428,183,428,372,615,183,615,372,0.06661748886108398
519,279,187,191,0,0.3970000147819519,519.5,375,426,279.5,426,184,426,375,613,184,613,375,0.0666661262512207
517,280,186,190,0,0.3970000147819519,517.0,375,424,280.0,424,185,424,375,610,185,610,375,0.06708979606628418
513,281,186,190,0,0.3930000066757202,513.0,376,420,281.0,420,186,420,376,606,186,606,376,0.06584572792053223
509,283,186,190,0,0.39100003242492676,509.0,378,416,283.0,416,188,416,378,602,188,602,378,0.06727766990661621
504,284,187,189,0,0.39000001549720764,504.5,379,411,284.5,411,190,411,379,598,190,598,379,0.06658196449279785
500,286,186,191,0,0.3850000202655792,500.0,382,407,286.5,407,191,407,382,593,191,593,382,0.06699132919311523
495,289,186,192,0,0.38200002908706665,495.0,385,402,289.0,402,193,402,385,588,193,588,385,0.0668036937713623
489,291,186,193,0,0.37800002098083496,489.0,388,396,291.5,396,195,396,388,582,195,582,388,0.06681299209594727
482,296,186,199,0,0.3720000088214874,482.0,396,389,296.5,389,197,389,396,575,197,575,396,0.06579947471618652
473,299,185,197,0,0.3700000047683716,473.5,398,381,299.5,381,201,381,398,566,201,566,398,0.06767773628234863
465,302,185,198,0,0.3660000264644623,465.5,401,373,302.0,373,203,373,401,558,203,558,401,0.06699275970458984
456,305,185,199,0,0.36100003123283386,456.5,405,364,305.5,364,206,364,405,549,206,549,405,0.06737136840820312
446,309,183,201,0,0.35600000619888306,446.5,410,355,309.5,355,209,355,410,538,209,538,410,0.0654137134552002
435,314,184,202,0,0.3500000238418579,435.0,415,343,314.0,343,213,343,415,527,213,527,415,0.06574368476867676
423,318,183,203,0,0.3440000116825104,423.5,420,332,318.5,332,217,332,420,515,217,515,420,0.06651186943054199
410,324,180,205,0,0.33900001645088196,410.0,427,320,324.5,320,222,320,427,500,222,500,427,0.0657646656036377
396,329,180,207,0,0.3330000042915344,396.0,433,306,329.5,306,226,306,433,486,226,486,433,0.0679936408996582
380,335,181,208,0,0.32600000500679016,380.5,439,290,335.0,290,231,290,439,471,231,471,439,0.06509852409362793
363,341,181,208,0,0.32100000977516174,363.5,445,273,341.0,273,237,273,445,454,237,454,445,0.06657814979553223
345,347,183,210,0,0.31700000166893005,345.5,452,254,347.0,254,242,254,452,437,242,437,452,0.06664609909057617
328,353,185,212,0,0.31200000643730164,328.5,459,236,353.0,236,247,236,459,421,247,421,459,0.06649398803710938
311,357,185,213,0,0.0,311.5,464,219,357.5,219,251,219,464,404,251,404,464,0.0671243667602539
295,363,188,214,0,0.0,295.0,470,201,363.0,201,256,201,470,389,256,389,470,0.06603336334228516
278,367,191,215,0,0.0,278.5,475,183,367.5,183,260,183,475,374,260,374,475,0.06682300567626953
263,371,192,217,0,0.0,263.0,480,167,371.5,167,263,167,480,359,263,359,480,0.06679058074951172
248,373,192,213,0,0.0,248.0,480,152,373.5,152,267,152,480,344,267,344,480,0.06673264503479004
233,375,195,209,0,0.0,233.5,480,136,375.5,136,271,136,480,331,271,331,480,0.06671977043151855
221,377,198,206,0,0.0,221.0,480,122,377.0,122,274,122,480,320,274,320,480,0.06740236282348633
208,378,199,203,0,0.0,208.5,480,109,378.5,109,277,109,480,308,277,308,480,0.06537580490112305
197,380,201,200,0,0.0,197.5,480,97,380.0,97,280,97,480,298,280,298,480,0.06709027290344238
187,380,202,197,0,0.0,187.0,479,86,380.5,86,282,86,479,288,282,288,479,0.0662076473236084
178,381,204,195,0,0.0,178.0,479,76,381.5,76,284,76,479,280,284,280,479,0.06715536117553711
170,382,204,193,0,0.0,170.0,479,68,382.5,68,286,68,479,272,286,272,479,0.06602978706359863
162,383,206,191,0,0.0,162.0,479,59,383.5,59,288,59,479,265,288,265,479,0.06721377372741699
156,384,206,190,0,0.0,156.0,479,53,384.0,53,289,53,479,259,289,259,479,0.06626486778259277
150,384,209,189,0,0.0,150.5,479,46,384.5,46,290,46,479,255,290,255,479,0.06607842445373535
146,385,207,188,0,0.0,146.5,479,43,385.0,43,291,43,479,250,291,250,479,0.06704854965209961
143,385,207,187,0,0.0,143.5,479,40,385.5,40,292,40,479,247,292,247,479,0.06732392311096191
142,386,208,186,0,0.0,142.0,479,38,386.0,38,293,38,479,246,293,246,479,0.06605815887451172
142,386,208,186,0,0.0,142.0,479,38,386.0,38,293,38,479,246,293,246,479,0.06631827354431152
143,386,208,186,0,0.0,143.0,479,39,386.0,39,293,39,479,247,293,247,479,0.06589794158935547
144,385,208,187,0,0.0,144.0,479,40,385.5,40,292,40,479,248,292,248,479,0.06675529479980469
145,385,207,188,0,0.0,145.5,479,42,385.0,42,291,42,479,249,291,249,479,0.06654858589172363
149,384,207,189,0,0.0,149.5,479,46,384.5,46,290,46,479,253,290,253,479,0.06680870056152344
154,383,206,191,0,0.0,154.0,479,51,383.5,51,288,51,479,257,288,257,479,0.06654238700866699
160,383,206,192,0,0.0,160.0,479,57,383.0,57,287,57,479,263,287,263,479,0.0671992301940918
166,381,204,195,0,0.0,166.0,479,64,381.5,64,284,64,479,268,284,268,479,0.06673502922058105
174,380,202,198,0,0.0,174.0,479,73,380.0,73,281,73,479,275,281,275,479,0.0663301944732666
182,378,201,201,0,0.2110000103712082,182.5,479,82,378.5,82,278,82,479,283,278,283,479,0.06578516960144043
192,377,200,204,0,0.0,192.0,479,92,377.0,92,275,92,479,292,275,292,479,0.0670766830444336
202,375,199,208,0,0.0,202.5,479,103,375.0,103,271,103,479,302,271,302,479,0.06615900993347168
212,373,197,212,0,0.0,212.5,479,114,373.0,114,267,114,479,311,267,311,479,0.06732749938964844
224,370,195,216,0,0.0,224.5,478,127,370.0,127,262,127,478,322,262,322,478,0.0665140151977539
237,366,192,216,0,0.0,237.0,474,141,366.0,141,258,141,474,333,258,333,474,0.06623268127441406
249,360,190,214,0,0.0,249.0,467,154,360.0,154,253,154,467,344,253,344,467,0.06780028343200684
263,354,189,212,0,0.0,263.5,460,169,354.0,169,248,169,460,358,248,358,460,0.06616854667663574
277,346,187,211,0,0.0,277.5,452,184,346.5,184,241,184,452,371,241,371,452,0.06640839576721191
291,341,185,210,0,0.0,291.5,446,199,341.0,199,236,199,446,384,236,384,446,0.06690239906311035
306,333,183,208,0,0.0,306.5,437,215,333.0,215,229,215,437,398,229,398,437,0.06647753715515137
321,325,181,205,0,0.0,321.5,428,231,325.5,231,223,231,428,412,223,412,428,0.06704497337341309
336,320,178,206,0,0.0,336.0,423,247,320.0,247,217,247,423,425,217,425,423,0.06629085540771484
351,311,177,204,0,0.0,351.5,413,263,311.0,263,209,263,413,440,209,440,413,0.06603574752807617
365,302,173,203,0,0.33900001645088196,365.5,404,279,302.5,279,201,279,404,452,201,452,404,0.06681203842163086
380,295,173,200,0,0.3460000157356262,380.5,395,294,295.0,294,195,294,395,467,195,467,395,0.06670904159545898
387,292,172,201,0,0.3500000238418579,387.0,393,301,292.5,301,192,301,393,473,192,473,393,0.06747937202453613
406,280,170,197,0,0.36100003123283386,406.0,379,321,280.5,321,182,321,379,491,182,491,379,0.07095718383789062
416,272,171,195,0,0.3700000047683716,416.5,370,331,272.5,331,175,331,370,502,175,502,370,0.06440329551696777
426,268,170,195,0,0.3760000169277191,426.0,366,341,268.5,341,171,341,366,511,171,511,366,0.06425118446350098
433,263,171,194,0,0.38100001215934753,433.5,360,348,263.0,348,166,348,360,519,166,519,360,0.06555461883544922
442,258,172,192,0,0.38600000739097595,442.0,354,356,258.0,356,162,356,354,528,162,528,354,0.06695103645324707
448,252,172,191,0,0.3930000066757202,448.0,348,362,252.5,362,157,362,348,534,157,534,348,0.06652116775512695
454,249,172,190,0,0.398000031709671,454.0,344,368,249.0,368,154,368,344,540,154,540,344,0.06659746170043945
460,244,173,189,0,0.4000000059604645,460.5,339,374,244.5,374,150,374,339,547,150,547,339,0.06654834747314453
466,242,174,190,0,0.4050000309944153,466.0,337,379,242.0,379,147,379,337,553,147,553,337,0.06662940979003906
470,238,173,187,0,0.4090000092983246,470.5,332,384,238.5,384,145,384,332,557,145,557,332,0.06640243530273438
475,235,173,187,0,0.4150000214576721,475.5,329,389,235.5,389,142,389,329,562,142,562,329,0.06693196296691895
479,231,173,187,0,0.41700002551078796,479.5,325,393,231.5,393,138,393,325,566,138,566,325,0.06644630432128906
483,229,173,186,0,0.42100003361701965,483.5,322,397,229.0,397,136,397,322,570,136,570,322,0.06633496284484863
488,225,172,185,0,0.4270000159740448,488.0,318,402,225.5,402,133,402,318,574,133,574,318,0.06634068489074707
491,223,172,184,0,0.43300002813339233,491.0,315,405,223.0,405,131,405,315,577,131,577,315,0.06667065620422363
494,221,172,185,0,0.4360000193119049,494.0,314,408,221.5,408,129,408,314,580,129,580,314,0.06753277778625488
497,219,171,185,0,0.4400000274181366,497.5,312,412,219.5,412,127,412,312,583,127,583,312,0.06556296348571777
501,217,172,183,0,0.44300001859664917,501.0,309,415,217.5,415,126,415,309,587,126,587,309,0.06716227531433105
503,216,171,183,0,0.445000022649765,503.5,308,418,216.5,418,125,418,308,589,125,589,308,0.06601548194885254
506,214,171,184,0,0.4520000219345093,506.5,306,421,214.0,421,122,421,306,592,122,592,306,0.07340288162231445
508,212,170,183,0,0.453000009059906,508.0,304,423,212.5,423,121,423,304,593,121,593,304,0.06061530113220215
510,211,170,183,0,0.453000009059906,510.0,303,425,211.5,425,120,425,303,595,120,595,303,0.06542301177978516
513,209,170,180,0,0.4570000171661377,513.0,299,428,209.0,428,119,428,299,598,119,598,299,0.06818127632141113
514,208,171,181,0,0.46000000834465027,514.5,299,429,208.5,429,118,429,299,600,118,600,299,0.06603813171386719
516,208,170,183,0,0.45900002121925354,516.0,300,431,208.5,431,117,431,300,601,117,601,300,0.0660555362701416
517,205,169,181,0,0.4700000286102295,517.5,296,433,205.5,433,115,433,296,602,115,602,296,0.06707453727722168
519,206,170,182,0,0.46700000762939453,519.0,297,434,206.0,434,115,434,297,604,115,604,297,0.06606650352478027
520,204,169,180,0,0.4710000157356262,520.5,294,436,204.0,436,114,436,294,605,114,605,294,0.06701993942260742
521,203,169,178,0,0.4710000157356262,521.5,292,437,203.0,437,114,437,292,606,114,606,292,0.06673836708068848
523,202,170,178,0,0.4740000367164612,523.0,291,438,202.0,438,113,438,291,608,113,608,291,0.06618070602416992
524,201,169,177,0,0.47600001096725464,524.5,290,440,201.5,440,113,440,290,609,113,609,290,0.06668400764465332
525,200,168,177,0,0.4740000367164612,525.0,289,441,200.5,441,112,441,289,609,112,609,289,0.06622910499572754
526,200,168,176,0,0.4750000238418579,526.0,288,442,200.0,442,112,442,288,610,112,610,288,0.06742382049560547
527,199,168,177,0,0.4750000238418579,527.0,288,443,199.5,443,111,443,288,611,111,611,288,0.06674790382385254
528,200,168,179,0,0.4790000319480896,528.0,290,444,200.5,444,111,444,290,612,111,612,290,0.0662994384765625
528,200,168,181,0,0.47700002789497375,528.0,291,444,200.5,444,110,444,291,612,110,612,291,0.06724691390991211
529,199,168,179,0,0.48100003600120544,529.0,289,445,199.5,445,110,445,289,613,110,613,289,0.06561064720153809
529,200,168,181,0,0.47700002789497375,529.0,291,445,200.5,445,110,445,291,613,110,613,291,0.06680727005004883
530,199,168,181,0,0.48000001907348633,530.0,290,446,199.5,446,109,446,290,614,109,614,290,0.06733942031860352
530,199,167,180,0,0.4830000102519989,530.5,289,447,199.0,447,109,447,289,614,109,614,289,0.06515121459960938
530,198,167,178,0,0.48500001430511475,530.5,287,447,198.0,447,109,447,287,614,109,614,287,0.0679175853729248
531,197,168,176,0,0.4820000231266022,531.0,285,447,197.0,447,109,447,285,615,109,615,285,0.06536507606506348
530,197,167,177,0,0.48600003123283386,530.5,286,447,197.5,447,109,447,286,614,109,614,286,0.06706619262695312
530,197,167,176,0,0.4820000231266022,530.5,285,447,197.0,447,109,447,285,614,109,614,285,0.06706023216247559
530,197,167,177,0,0.484000027179718,530.5,286,447,197.5,447,109,447,286,614,109,614,286,0.06593608856201172
530,197,167,177,0,0.48000001907348633,530.5,286,447,197.5,447,109,447,286,614,109,614,286,0.06696295738220215
530,198,167,178,0,0.48000001907348633,530.5,287,447,198.0,447,109,447,287,614,109,614,287,0.0661625862121582
529,198,167,178,0,0.4870000183582306,529.5,287,446,198.0,446,109,446,287,613,109,613,287,0.067230224609375
529,201,166,182,0,0.4790000319480896,529.0,292,446,201.0,446,110,446,292,612,110,612,292,0.06761813163757324
528,201,167,180,0,0.48500001430511475,528.5,291,445,201.0,445,111,445,291,612,111,612,291,0.0651240348815918
527,203,167,182,0,0.4830000102519989,527.5,294,444,203.0,444,112,444,294,611,112,611,294,0.06699967384338379
526,202,166,178,0,0.48500001430511475,526.0,291,443,202.0,443,113,443,291,609,113,609,291,0.06633281707763672
525,202,166,175,0,0.48500001430511475,525.0,290,442,202.5,442,115,442,290,608,115,608,290,0.06724071502685547
522,203,165,175,0,0.4780000150203705,522.5,291,440,203.5,440,116,440,291,605,116,605,291,0.06651663780212402
520,206,165,176,0,0.4780000150203705,520.5,294,438,206.0,438,118,438,294,603,118,603,294,0.06609153747558594
518,211,165,181,0,0.4740000367164612,518.5,302,436,211.5,436,121,436,302,601,121,601,302,0.06650829315185547
516,211,164,176,0,0.4750000238418579,516.0,299,434,211.0,434,123,434,299,598,123,598,299,0.0666055679321289
513,218,163,184,0,0.4740000367164612,513.5,310,432,218.0,432,126,432,310,595,126,595,310,0.06651544570922852
511,215,162,174,0,0.47600001096725464,511.0,302,430,215.0,430,128,430,302,592,128,592,302,0.06739974021911621
507,217,161,173,0,0.47300001978874207,507.5,304,427,217.5,427,131,427,304,588,131,588,304,0.0660703182220459
504,219,160,173,0,0.47300001978874207,504.0,306,424,219.5,424,133,424,306,584,133,584,306,0.06642866134643555
500,222,159,173,0,0.4740000367164612,500.5,309,421,222.5,421,136,421,309,580,136,580,309,0.06683945655822754
497,225,158,171,0,0.47300001978874207,497.0,311,418,225.5,418,140,418,311,576,140,576,311,0.06631612777709961
493,229,156,170,0,0.4690000116825104,493.0,314,415,229.0,415,144,415,314,571,144,571,314,0.06712460517883301
489,231,156,167,0,0.46800002455711365,489.0,315,411,231.5,411,148,411,315,567,148,567,315,0.06602597236633301
485,235,154,169,0,0.46700000762939453,485.0,320,408,235.5,408,151,408,320,562,151,562,320,0.06753396987915039
480,241,152,168,0,0.4620000123977661,480.0,325,404,241.0,404,157,404,325,556,157,556,325,0.0660238265991211
475,244,151,169,0,0.46300002932548523,475.5,329,400,244.5,400,160,400,329,551,160,551,329,0.06693196296691895
470,248,149,169,0,0.4580000340938568,470.5,333,396,248.5,396,164,396,333,545,164,545,333,0.06634187698364258
466,251,148,166,0,0.45900002121925354,466.0,334,392,251.0,392,168,392,334,540,168,540,334,0.06671953201293945
460,255,147,166,0,0.4580000340938568,460.5,338,387,255.0,387,172,387,338,534,172,534,338,0.06791019439697266
454,258,145,161,0,0.4580000340938568,454.5,339,382,258.5,382,178,382,339,527,178,527,339,0.06527924537658691
448,262,143,163,0,0.4580000340938568,448.5,344,377,262.5,377,181,377,344,520,181,520,344,0.06684184074401855
442,268,140,163,0,0.45600003004074097,442.0,350,372,268.5,372,187,372,350,512,187,512,350,0.06630420684814453
437,272,138,161,0,0.45500001311302185,437.0,353,368,272.5,368,192,368,353,506,192,506,353,0.06649661064147949
430,276,136,160,0,0.45500001311302185,430.0,356,362,276.0,362,196,362,356,498,196,498,356,0.06787705421447754
424,280,135,158,0,0.4540000259876251,424.5,359,357,280.0,357,201,357,359,492,201,492,359,0.06576704978942871
419,283,132,156,0,0.4540000259876251,419.0,361,353,283.0,353,205,353,361,485,205,485,361,0.06658434867858887
412,288,131,156,0,0.45100003480911255,412.5,366,347,288.0,347,210,347,366,478,210,478,366,0.06617927551269531
407,291,129,154,0,0.44700002670288086,407.5,368,343,291.0,343,214,343,368,472,214,472,368,0.06637191772460938
403,294,128,153,0,0.4480000138282776,403.0,371,339,294.5,339,218,339,371,467,218,467,371,0.06662702560424805
398,296,127,149,0,0.4480000138282776,398.5,371,335,296.5,335,222,335,371,462,222,462,371,0.06734895706176758
393,299,125,151,0,0.45000001788139343,393.5,375,331,299.5,331,224,331,375,456,224,456,375,0.06598091125488281
389,302,124,149,0,0.4490000307559967,389.0,377,327,302.5,327,228,327,377,451,228,451,377,0.06671595573425293
385,305,123,150,0,0.45100003480911255,385.5,380,324,305.0,324,230,324,380,447,230,447,380,0.0663442611694336
381,307,122,148,0,0.45000001788139343,381.0,381,320,307.0,320,233,320,381,442,233,442,381,0.06635618209838867
377,310,120,148,0,0.445000022649765,377.0,384,317,310.0,317,236,317,384,437,236,437,384,0.0688924789428711
373,312,119,146,0,0.445000022649765,373.5,385,314,312.0,314,239,314,385,433,239,433,385,0.06392216682434082
371,314,120,147,0,0.44600000977516174,371.0,388,311,314.5,311,241,311,388,431,241,431,388,0.06723713874816895
367,315,119,146,0,0.445000022649765,367.5,388,308,315.0,308,242,308,388,427,242,427,388,0.06739282608032227
364,317,117,146,0,0.44300001859664917,364.5,390,306,317.0,306,244,306,390,423,244,423,390,0.0657660961151123
361,319,117,146,0,0.44300001859664917,361.5,392,303,319.0,303,246,303,392,420,246,420,392,0.06903243064880371
359,320,117,145,0,0.44600000977516174,359.5,393,301,320.5,301,248,301,393,418,248,418,393,0.06414175033569336
356,321,116,143,0,0.445000022649765,356.0,393,298,321.5,298,250,298,393,414,250,414,393,0.06685256958007812
353,322,115,143,0,0.4440000355243683,353.5,394,296,322.5,296,251,296,394,411,251,411,394,0.0666508674621582
352,324,115,142,0,0.44700002670288086,352.5,395,295,324.0,295,253,295,395,410,253,410,395,0.0670619010925293
351,324,114,141,0,0.445000022649765,351.0,395,294,324.5,294,254,294,395,408,254,408,395,0.06672883033752441
349,325,115,141,0,0.4440000355243683,349.5,396,292,325.5,292,255,292,396,407,255,407,396,0.0662989616394043
347,326,115,140,0,0.445000022649765,347.5,396,290,326.0,290,256,290,396,405,256,405,396,0.06714582443237305
347,327,114,141,0,0.445000022649765,347.0,398,290,327.5,290,257,290,398,404,257,404,398,0.06576371192932129
345,328,113,142,0,0.44600000977516174,345.5,399,289,328.0,289,257,289,399,402,257,402,399,0.0668797492980957
345,328,114,142,0,0.44600000977516174,345.0,399,288,328.0,288,257,288,399,402,257,402,399,0.06640338897705078
345,328,114,142,0,0.44700002670288086,345.0,399,288,328.0,288,257,288,399,402,257,402,399,0.06632423400878906
344,328,114,142,0,0.44700002670288086,344.0,399,287,328.0,287,257,287,399,401,257,401,399,0.06644630432128906
344,328,114,142,0,0.4480000138282776,344.0,399,287,328.0,287,257,287,399,401,257,401,399,0.06704831123352051
344,327,114,141,0,0.44600000977516174,344.0,398,287,327.5,287,257,287,398,401,257,401,398,0.06606173515319824
344,328,114,142,0,0.44700002670288086,344.0,399,287,328.0,287,257,287,399,401,257,401,399,0.06717681884765625
343,328,115,141,0,0.4480000138282776,343.5,399,286,328.5,286,258,286,399,401,258,401,399,0.06668400764465332
343,328,114,142,0,0.4490000307559967,343.0,399,286,328.0,286,257,286,399,400,257,400,399,0.06672430038452148
342,327,115,141,0,0.4480000138282776,342.5,398,285,327.5,285,257,285,398,400,257,400,398,0.0676870346069336
341,327,115,141,0,0.4480000138282776,341.5,398,284,327.5,284,257,284,398,399,257,399,398,0.06511545181274414
341,327,114,141,0,0.45000001788139343,341.0,398,284,327.5,284,257,284,398,398,257,398,398,0.06688833236694336
340,326,114,140,0,0.45100003480911255,340.0,396,283,326.0,283,256,283,396,397,256,397,396,0.06668877601623535
339,326,114,141,0,0.45100003480911255,339.0,397,282,326.5,282,256,282,397,396,256,396,397,0.06607389450073242
338,325,114,141,0,0.45100003480911255,338.0,396,281,325.5,281,255,281,396,395,255,395,396,0.06787848472595215
335,325,113,140,0,0.45100003480911255,335.5,395,279,325.0,279,255,279,395,392,255,392,395,0.06655192375183105
334,324,114,140,0,0.4520000219345093,334.0,394,277,324.0,277,254,277,394,391,254,391,394,0.06574487686157227
332,323,114,140,0,0.45500001311302185,332.0,393,275,323.0,275,253,275,393,389,253,389,393,0.06754255294799805
330,322,113,140,0,0.45500001311302185,330.5,392,274,322.0,274,252,274,392,387,252,387,392,0.06542539596557617
327,321,113,141,0,0.45500001311302185,327.5,392,271,321.5,271,251,271,392,384,251,384,392,0.0667257308959961
325,321,112,142,0,0.4570000171661377,325.0,392,269,321.0,269,250,269,392,381,250,381,392,0.06713271141052246
322,320,112,140,0,0.45600003004074097,322.0,390,266,320.0,266,250,266,390,378,250,378,390,0.06620907783508301
320,318,112,139,0,0.45600003004074097,320.0,388,264,318.5,264,249,264,388,376,249,376,388,0.06669950485229492
317,317,113,139,0,0.4520000219345093,317.5,387,261,317.5,261,248,261,387,374,248,374,387,0.0659177303314209
314,316,113,140,0,0.4520000219345093,314.5,386,258,316.0,258,246,258,386,371,246,371,386,0.06756234169006348
311,314,113,139,0,0.0,311.5,384,255,314.5,255,245,255,384,368,245,368,384,0.06584572792053223
308,313,112,139,0,0.4320000112056732,308.0,383,252,313.5,252,244,252,383,364,244,364,383,0.06723237037658691
305,311,112,139,0,0.41600000858306885,305.0,381,249,311.5,249,242,249,381,361,242,361,381,0.06640982627868652
301,310,111,139,0,0.42100003361701965,301.5,380,246,310.5,246,241,246,380,357,241,357,380,0.06652379035949707
298,309,112,138,0,0.41600000858306885,298.0,378,242,309.0,242,240,242,378,354,240,354,378,0.0677645206451416
295,307,112,138,0,0.4140000343322754,295.0,376,239,307.0,239,238,239,376,351,238,351,376,0.06546688079833984
291,306,111,138,0,0.41600000858306885,291.5,375,236,306.0,236,237,236,375,347,237,347,375,0.06714844703674316
287,304,112,138,0,0.41100001335144043,287.0,373,231,304.0,231,235,231,373,343,235,343,373,0.06594538688659668
283,302,112,137,0,0.4100000262260437,283.0,371,227,302.5,227,234,227,371,339,234,339,371,0.06652140617370605
279,300,112,137,0,0.41100001335144043,279.0,369,223,300.5,223,232,223,369,335,232,335,369,0.0675814151763916
275,298,112,138,0,0.4090000092983246,275.0,367,219,298.0,219,229,219,367,331,229,331,367,0.06626129150390625
271,296,111,139,0,0.40800002217292786,271.5,366,216,296.5,216,227,216,366,327,227,327,366,0.06632065773010254
267,295,110,141,0,0.4100000262260437,267.0,366,212,295.5,212,225,212,366,322,225,322,366,0.06667208671569824
262,295,110,145,0,0.4130000174045563,262.0,368,207,295.5,207,223,207,368,317,223,317,368,0.06650114059448242
257,292,110,141,0,0.4150000214576721,257.0,363,202,292.5,202,222,202,363,312,222,312,363,0.06714200973510742
252,289,111,140,0,0.4180000126361847,252.5,359,197,289.0,197,219,197,359,308,219,308,359,0.06644177436828613
248,285,111,136,0,0.41100001335144043,248.5,353,193,285.0,193,217,193,353,304,217,304,353,0.0667731761932373
243,283,110,138,0,0.4140000343322754,243.0,352,188,283.0,188,214,188,352,298,214,298,352,0.06677532196044922
238,280,111,138,0,0.4100000262260437,238.5,349,183,280.0,183,211,183,349,294,211,294,349,0.06634187698364258
233,277,111,138,0,0.41100001335144043,233.5,346,178,277.0,178,208,178,346,289,208,289,346,0.06679582595825195
229,275,110,141,0,0.4150000214576721,229.0,346,174,275.5,174,205,174,346,284,205,284,346,0.06645703315734863
223,274,110,142,0,0.0,223.0,345,168,274.0,168,203,168,345,278,203,278,345,0.06638216972351074
218,269,111,137,0,0.42900002002716064,218.5,338,163,269.5,163,201,163,338,274,201,274,338,0.06649160385131836
213,266,109,137,0,0.0,213.5,335,159,266.5,159,198,159,335,268,198,268,335,0.06663656234741211
209,268,111,148,0,0.0,209.5,342,154,268.0,154,194,154,342,265,194,265,342,0.06642627716064453
205,263,110,142,0,0.0,205.0,334,150,263.0,150,192,150,334,260,192,260,334,0.06690716743469238
201,266,110,152,0,0.4790000319480896,201.0,342,146,266.0,146,190,146,342,256,190,256,342,0.06676340103149414
196,256,109,138,0,0.0,196.5,325,142,256.0,142,187,142,325,251,187,251,325,0.0663764476776123
192,253,111,137,0,0.0,192.5,322,137,253.5,137,185,137,322,248,185,248,322,0.06652593612670898
189,251,110,138,0,0.0,189.0,320,134,251.0,134,182,134,320,244,182,244,320,0.06636571884155273
185,247,111,137,0,0.0,185.5,316,130,247.5,130,179,130,316,241,179,241,316,0.06707549095153809
182,245,110,136,0,0.0,182.0,313,127,245.0,127,177,127,313,237,177,237,313,0.06596827507019043
178,242,111,135,0,0.0,178.5,310,123,242.5,123,175,123,310,234,175,234,310,0.06745672225952148
176,241,110,137,0,0.0,176.0,310,121,241.5,121,173,121,310,231,173,231,310,0.0663752555847168
172,239,110,136,0,0.0,172.0,307,117,239.0,117,171,117,307,227,171,227,307,0.06720757484436035
169,236,111,135,0,0.0,169.5,304,114,236.5,114,169,114,304,225,169,225,304,0.06558561325073242
166,235,111,136,0,0.0,166.5,303,111,235.0,111,167,111,303,222,167,222,303,0.06796026229858398
164,233,110,138,0,0.0,164.0,302,109,233.0,109,164,109,302,219,164,219,302,0.06593132019042969
161,231,111,138,0,0.5040000081062317,161.5,300,106,231.0,106,162,106,300,217,162,217,300,0.0661780834197998
159,231,112,142,0,0.4970000088214874,159.0,302,103,231.0,103,160,103,302,215,160,215,302,0.06644892692565918
156,232,111,147,0,0.5010000467300415,156.5,306,101,232.5,101,159,101,306,212,159,212,306,0.06735110282897949
154,230,111,146,0,0.49800002574920654,154.5,303,99,230.0,99,157,99,303,210,157,210,303,0.06573057174682617
152,225,111,139,0,0.5020000338554382,152.5,295,97,225.5,97,156,97,295,208,156,208,295,0.06726431846618652
150,223,111,138,0,0.503000020980835,150.5,292,95,223.0,95,154,95,292,206,154,206,292,0.06672310829162598
148,222,111,138,0,0.5080000162124634,148.5,291,93,222.0,93,153,93,291,204,153,204,291,0.06575798988342285
146,220,111,137,0,0.5040000081062317,146.5,289,91,220.5,91,152,91,289,202,152,202,289,0.06700348854064941
145,218,110,137,0,0.503000020980835,145.0,287,90,218.5,90,150,90,287,200,150,200,287,0.06632065773010254
144,217,111,137,0,0.5049999952316284,144.5,286,89,217.5,89,149,89,286,200,149,200,286,0.06851625442504883
142,216,111,138,0,0.5110000371932983,142.5,285,87,216.0,87,147,87,285,198,147,198,285,0.06553244590759277
141,215,110,138,0,0.5100000500679016,141.0,284,86,215.0,86,146,86,284,196,146,196,284,0.0657200813293457
139,214,111,138,0,0.5070000290870667,139.5,283,84,214.0,84,145,84,283,195,145,195,283,0.0669097900390625
138,216,111,142,0,0.5120000243186951,138.5,287,83,216.0,83,145,83,287,194,145,194,287,0.06693220138549805
137,213,111,138,0,0.5080000162124634,137.5,282,82,213.0,82,144,82,282,193,144,193,282,0.0664525032043457
137,211,112,135,0,0.5120000243186951,137.0,279,81,211.5,81,144,81,279,193,144,193,279,0.06702113151550293
136,211,111,137,0,0.5160000324249268,136.5,280,81,211.5,81,143,81,280,192,143,192,280,0.066009521484375
135,210,111,137,0,0.5100000500679016,135.5,279,80,210.5,80,142,80,279,191,142,191,279,0.06680631637573242
135,211,110,139,0,0.51500004529953,135.0,281,80,211.5,80,142,80,281,190,142,190,281,0.06626725196838379
134,211,111,140,0,0.5100000500679016,134.5,281,79,211.0,79,141,79,281,190,141,190,281,0.06759810447692871
134,210,110,139,0,0.51500004529953,134.0,280,79,210.5,79,141,79,280,189,141,189,280,0.06598830223083496
133,211,111,140,0,0.5120000243186951,133.5,281,78,211.0,78,141,78,281,189,141,189,281,0.06682395935058594
133,210,110,140,0,0.5090000033378601,133.0,280,78,210.0,78,140,78,280,188,140,188,280,0.06694626808166504
133,210,110,140,0,0.5130000114440918,133.0,280,78,210.0,78,140,78,280,188,140,188,280,0.06596183776855469
133,209,110,139,0,0.5090000033378601,133.0,279,78,209.5,78,140,78,279,188,140,188,279,0.06827592849731445
133,209,110,137,0,0.51500004529953,133.0,278,78,209.5,78,141,78,278,188,141,188,278,0.06561636924743652
133,209,110,139,0,0.51500004529953,133.0,279,78,209.5,78,140,78,279,188,140,188,279,0.06541728973388672
133,209,111,139,0,0.5190000534057617,133.5,279,78,209.5,78,140,78,279,189,140,189,279,0.06766200065612793
134,210,110,140,0,0.51500004529953,134.0,280,79,210.0,79,140,79,280,189,140,189,280,0.0661613941192627
134,210,111,139,0,0.5130000114440918,134.5,280,79,210.5,79,141,79,280,190,141,190,280,0.06639313697814941
135,210,111,139,0,0.5120000243186951,135.5,280,80,210.5,80,141,80,280,191,141,191,280,0.0669107437133789
136,210,111,139,0,0.5130000114440918,136.5,280,81,210.5,81,141,81,280,192,141,192,280,0.0663607120513916
137,214,111,144,0,0.5120000243186951,137.5,286,82,214.0,82,142,82,286,193,142,193,286,0.06744265556335449
138,211,112,138,0,0.5070000290870667,138.0,280,82,211.0,82,142,82,280,194,142,194,280,0.06580567359924316
139,211,111,139,0,0.5139999985694885,139.5,281,84,211.5,84,142,84,281,195,142,195,281,0.06696653366088867
140,211,111,139,0,0.5130000114440918,140.5,281,85,211.5,85,142,85,281,196,142,196,281,0.06680130958557129
142,211,112,136,0,0.5130000114440918,142.0,279,86,211.0,86,143,86,279,198,143,198,279,0.06610703468322754
143,212,111,136,0,0.5049999952316284,143.5,280,88,212.0,88,144,88,280,199,144,199,280,0.06703543663024902
145,212,112,137,0,0.5060000419616699,145.0,281,89,212.5,89,144,89,281,201,144,201,281,0.06646203994750977
147,214,112,138,0,0.5060000419616699,147.0,283,91,214.0,91,145,91,283,203,145,203,283,0.06720781326293945
148,214,111,138,0,0.5020000338554382,148.5,283,93,214.0,93,145,93,283,204,145,204,283,0.06628131866455078
150,214,113,139,0,0.5020000338554382,150.5,284,94,214.5,94,145,94,284,207,145,207,284,0.06595873832702637
153,214,112,138,0,0.5060000419616699,153.0,283,97,214.0,97,145,97,283,209,145,209,283,0.0672144889831543
155,215,111,139,0,0.5049999952316284,155.5,285,100,215.5,100,146,100,285,211,146,211,285,0.06668424606323242
157,219,112,144,0,0.5010000467300415,157.0,291,101,219.0,101,147,101,291,213,147,213,291,0.06615900993347168
160,218,112,142,0,0.5040000081062317,160.0,289,104,218.0,104,147,104,289,216,147,216,289,0.06712079048156738
162,218,113,142,0,0.5020000338554382,162.5,289,106,218.0,106,147,106,289,219,147,219,289,0.06602740287780762
165,218,113,141,0,0.0,165.5,289,109,218.5,109,148,109,289,222,148,222,289,0.06661391258239746
168,218,113,141,0,0.0,168.5,289,112,218.5,112,148,112,289,225,148,225,289,0.0665130615234375
171,219,112,143,0,0.0,171.0,291,115,219.5,115,148,115,291,227,148,227,291,0.06674432754516602
175,220,112,143,0,0.0,175.0,292,119,220.5,119,149,119,292,231,149,231,292,0.06661629676818848
178,221,112,140,0,0.0,178.0,291,122,221.0,122,151,122,291,234,151,234,291,0.06969499588012695
181,221,113,140,0,0.0,181.5,291,125,221.0,125,151,125,291,238,151,238,291,0.06456708908081055
185,223,113,142,0,0.39900001883506775,185.5,294,129,223.0,129,152,129,294,242,152,242,294,0.06549668312072754
189,228,113,151,0,0.0,189.5,304,133,228.5,133,153,133,304,246,153,246,304,0.06725764274597168
193,225,114,145,0,0.3960000276565552,193.0,298,136,225.5,136,153,136,298,250,153,250,298,0.06623172760009766
198,224,114,143,0,0.39900001883506775,198.0,296,141,224.5,141,153,141,296,255,153,255,296,0.0661780834197998
202,226,114,144,0,0.0,202.0,298,145,226.0,145,154,145,298,259,154,259,298,0.0668492317199707
207,228,114,147,0,0.0,207.0,302,150,228.5,150,155,150,302,264,155,264,302,0.06748771667480469
211,230,114,148,0,0.39400002360343933,211.0,304,154,230.0,154,156,154,304,268,156,268,304,0.06572818756103516
216,228,114,145,0,0.4350000321865082,216.0,301,159,228.5,159,156,159,301,273,156,273,301,0.06648898124694824
221,232,115,151,0,0.0,221.5,308,164,232.5,164,157,164,308,279,157,279,308,0.06656002998352051
226,235,115,155,0,0.3920000195503235,226.5,313,169,235.5,169,158,169,313,284,158,284,313,0.06652712821960449
232,231,115,147,0,0.43700000643730164,232.5,305,175,231.5,175,158,175,305,290,158,290,305,0.06688237190246582
238,230,115,145,0,0.43700000643730164,238.5,303,181,230.5,181,158,181,303,296,158,296,303,0.0664358139038086
245,232,116,146,0,0.4360000193119049,245.0,305,187,232.0,187,159,187,305,303,159,303,305,0.06623053550720215
250,233,117,147,0,0.0,250.5,307,192,233.5,192,160,192,307,309,160,309,307,0.06692051887512207
257,233,117,147,0,0.43800002336502075,257.5,307,199,233.5,199,160,199,307,316,160,316,307,0.0662233829498291
264,233,116,147,0,0.44200003147125244,264.0,307,206,233.5,206,160,206,307,322,160,322,307,0.06759929656982422
271,234,118,149,0,0.43400001525878906,271.0,309,212,234.5,212,160,212,309,330,160,330,309,0.06681132316589355
278,235,119,150,0,0.43700000643730164,278.5,310,219,235.0,219,160,219,310,338,160,338,310,0.06540298461914062
286,236,119,150,0,0.4440000355243683,286.5,311,227,236.0,227,161,227,311,346,161,346,311,0.06734895706176758
294,237,120,152,0,0.4410000145435333,294.0,313,234,237.0,234,161,234,313,354,161,354,313,0.06628155708312988
303,236,120,152,0,0.0,303.0,312,243,236.0,243,160,243,312,363,160,363,312,0.06649160385131836
310,236,121,151,0,0.4280000329017639,310.5,312,250,236.5,250,161,250,312,371,161,371,312,0.06665897369384766
318,236,122,153,0,0.0,318.0,313,257,236.5,257,160,257,313,379,160,379,313,0.06650924682617188
325,237,121,154,0,0.0,325.5,314,265,237.0,265,160,265,314,386,160,386,314,0.06682276725769043
334,237,122,155,0,0.0,334.0,315,273,237.5,273,160,273,315,395,160,395,315,0.06621623039245605
342,238,122,156,0,0.0,342.0,316,281,238.0,281,160,281,316,403,160,403,316,0.06717181205749512
349,237,123,156,0,0.0,349.5,315,288,237.0,288,159,288,315,411,159,411,315,0.06775617599487305
357,237,124,155,0,0.0,357.0,315,295,237.5,295,160,295,315,419,160,419,315,0.06509661674499512
364,237,125,156,0,0.0,364.5,315,302,237.0,302,159,302,315,427,159,427,315,0.06728458404541016
371,237,127,158,0,0.0,371.5,316,308,237.0,308,158,308,316,435,158,435,316,0.0659182071685791
378,236,129,159,0,0.0,378.5,316,314,236.5,314,157,314,316,443,157,443,316,0.0668039321899414
386,237,130,158,0,0.4620000123977661,386.0,316,321,237.0,321,158,321,316,451,158,451,316,0.06689047813415527
392,236,131,159,0,0.4610000252723694,392.5,316,327,236.5,327,157,327,316,458,157,458,316,0.06604290008544922
399,236,131,159,0,0.4620000123977661,399.5,316,334,236.5,334,157,334,316,465,157,465,316,0.06720399856567383
405,235,133,161,0,0.46300002932548523,405.5,316,339,235.5,339,155,339,316,472,155,472,316,0.06587409973144531
412,235,136,162,0,0.4620000123977661,412.0,316,344,235.0,344,154,344,316,480,154,480,316,0.06773257255554199
417,234,137,161,0,0.4610000252723694,417.5,315,349,234.5,349,154,349,315,486,154,486,315,0.06607723236083984
423,234,139,162,0,0.4650000333786011,423.5,315,354,234.0,354,153,354,315,493,153,493,315,0.0661768913269043
429,233,141,163,0,0.45900002121925354,429.5,315,359,233.5,359,152,359,315,500,152,500,315,0.06825613975524902
435,233,142,164,0,0.4620000123977661,435.0,315,364,233.0,364,151,364,315,506,151,506,315,0.06468343734741211
441,232,143,167,0,0.4660000205039978,441.5,316,370,232.5,370,149,370,316,513,149,513,316,0.06702232360839844
446,231,145,167,0,0.4620000123977661,446.5,315,374,231.5,374,148,374,315,519,148,519,315,0.06664466857910156
452,231,148,166,0,0.4620000123977661,452.0,314,378,231.0,378,148,378,314,526,148,526,314,0.06628155708312988
456,230,149,167,0,0.4610000252723694,456.5,314,382,230.5,382,147,382,314,531,147,531,314,0.06728243827819824
462,230,150,168,0,0.45900002121925354,462.0,314,387,230.0,387,146,387,314,537,146,537,314,0.06589651107788086
466,229,151,169,0,0.46300002932548523,466.5,314,391,229.5,391,145,391,314,542,145,542,314,0.0666344165802002
471,229,152,170,0,0.46300002932548523,471.0,314,395,229.0,395,144,395,314,547,144,547,314,0.06797575950622559
475,228,153,169,0,0.4620000123977661,475.5,313,399,228.5,399,144,399,313,552,144,552,313,0.06584453582763672
480,228,155,170,0,0.46300002932548523,480.5,313,403,228.0,403,143,403,313,558,143,558,313,0.06668376922607422
483,227,157,171,0,0.4610000252723694,483.5,313,405,227.5,405,142,405,313,562,142,562,313,0.0662543773651123
488,226,158,171,0,0.4660000205039978,488.0,312,409,226.5,409,141,409,312,567,141,567,312,0.06678009033203125
491,226,159,171,0,0.46400001645088196,491.5,312,412,226.5,412,141,412,312,571,141,571,312,0.06661391258239746
495,226,160,173,0,0.46000000834465027,495.0,313,415,226.5,415,140,415,313,575,140,575,313,0.06610679626464844
498,225,161,173,0,0.46300002932548523,498.5,312,418,225.5,418,139,418,312,579,139,579,312,0.06764698028564453
501,226,162,175,0,0.46300002932548523,501.0,314,420,226.5,420,139,420,314,582,139,582,314,0.06557273864746094
504,226,162,179,0,0.4610000252723694,504.0,316,423,226.5,423,137,423,316,585,137,585,316,0.06717586517333984
507,224,163,175,0,0.46400001645088196,507.5,312,426,224.5,426,137,426,312,589,137,589,312,0.06677675247192383
509,224,165,177,0,0.4660000205039978,509.5,313,427,224.5,427,136,427,313,592,136,592,313,0.0660867691040039
511,225,165,178,0,0.46400001645088196,511.5,314,429,225.0,429,136,429,314,594,136,594,314,0.0672607421875
514,225,164,181,0,0.46300002932548523,514.0,316,432,225.5,432,135,432,316,596,135,596,316,0.06634306907653809
516,223,165,176,0,0.46800002455711365,516.5,311,434,223.0,434,135,434,311,599,135,599,311,0.06687164306640625
518,222,166,176,0,0.46700000762939453,518.0,310,435,222.0,435,134,435,310,601,134,601,310,0.06623506546020508
519,222,167,177,0,0.4660000205039978,519.5,311,436,222.5,436,134,436,311,603,134,603,311,0.06584930419921875
520,222,167,179,0,0.4620000123977661,520.5,312,437,222.5,437,133,437,312,604,133,604,312,0.06777524948120117
521,223,167,180,0,0.4610000252723694,521.5,313,438,223.0,438,133,438,313,605,133,605,313,0.06543135643005371
522,223,168,180,0,0.46700000762939453,522.0,313,438,223.0,438,133,438,313,606,133,606,313,0.06683230400085449
523,223,168,180,0,0.4620000123977661,523.0,313,439,223.0,439,133,439,313,607,133,607,313,0.06769776344299316
523,222,168,179,0,0.4650000333786011,523.0,312,439,222.5,439,133,439,312,607,133,607,312,0.06569504737854004
523,222,168,179,0,0.46700000762939453,523.0,312,439,222.5,439,133,439,312,607,133,607,312,0.06844377517700195
523,222,168,178,0,0.46300002932548523,523.0,311,439,222.0,439,133,439,311,607,133,607,311,0.06472015380859375
523,222,168,179,0,0.4650000333786011,523.0,312,439,222.5,439,133,439,312,607,133,607,312,0.06663751602172852
523,223,168,180,0,0.4620000123977661,523.0,313,439,223.0,439,133,439,313,607,133,607,313,0.06658196449279785
522,223,167,181,0,0.4650000333786011,522.5,314,439,223.5,439,133,439,314,606,133,606,314,0.06641077995300293
522,224,168,181,0,0.4610000252723694,522.0,315,438,224.5,438,134,438,315,606,134,606,315,0.06676244735717773
521,225,166,182,0,0.4610000252723694,521.0,316,438,225.0,438,134,438,316,604,134,604,316,0.06670761108398438
520,226,166,183,0,0.46000000834465027,520.0,318,437,226.5,437,135,437,318,603,135,603,318,0.06671261787414551
519,226,166,181,0,0.45900002121925354,519.0,317,436,226.5,436,136,436,317,602,136,602,317,0.06642627716064453
517,225,165,178,0,0.46300002932548523,517.5,314,435,225.0,435,136,435,314,600,136,600,314,0.06662821769714355
516,225,165,176,0,0.46700000762939453,516.5,313,434,225.0,434,137,434,313,599,137,599,313,0.06702375411987305
514,226,163,177,0,0.4650000333786011,514.5,315,433,226.5,433,138,433,315,596,138,596,315,0.06661725044250488
512,227,163,177,0,0.4660000205039978,512.5,316,431,227.5,431,139,431,316,594,139,594,316,0.06645345687866211
510,227,163,174,0,0.4660000205039978,510.5,314,429,227.0,429,140,429,314,592,140,592,314,0.0664358139038086
509,226,163,171,0,0.46800002455711365,509.5,312,428,226.5,428,141,428,312,591,141,591,312,0.06585168838500977
506,227,160,171,0,0.4690000116825104,506.0,313,426,227.5,426,142,426,313,586,142,586,313,0.06739640235900879
503,230,159,174,0,0.46700000762939453,503.5,317,424,230.0,424,143,424,317,583,143,583,317,0.06685256958007812
500,231,159,174,0,0.4660000205039978,500.5,318,421,231.0,421,144,421,318,580,144,580,318,0.06643104553222656
498,231,158,171,0,0.46400001645088196,498.0,317,419,231.5,419,146,419,317,577,146,577,317,0.06650352478027344
495,232,157,170,0,0.4660000205039978,495.5,317,417,232.0,417,147,417,317,574,147,574,317,0.07212996482849121
493,231,156,167,0,0.4690000116825104,493.0,315,415,231.5,415,148,415,315,571,148,571,315,0.061014413833618164
489,233,155,167,0,0.4690000116825104,489.5,317,412,233.5,412,150,412,317,567,150,567,317,0.06672286987304688
486,237,154,170,0,0.4660000205039978,486.0,322,409,237.0,409,152,409,322,563,152,563,322,0.06681561470031738
483,236,152,165,0,0.47300001978874207,483.0,319,407,236.5,407,154,407,319,559,154,559,319,0.06632542610168457
479,239,150,166,0,0.46700000762939453,479.0,322,404,239.0,404,156,404,322,554,156,554,322,0.06651663780212402
476,240,148,165,0,0.4690000116825104,476.0,323,402,240.5,402,158,402,323,550,158,550,323,0.06668663024902344
472,240,147,163,0,0.4700000286102295,472.5,322,399,240.5,399,159,399,322,546,159,546,322,0.0670938491821289
468,241,146,162,0,0.4740000367164612,468.0,322,395,241.0,395,160,395,322,541,160,541,322,0.06641459465026855
463,243,145,162,0,0.47300001978874207,463.5,324,391,243.0,391,162,391,324,536,162,536,324,0.06733584403991699
459,244,144,162,0,0.47300001978874207,459.0,325,387,244.0,387,163,387,325,531,163,531,325,0.06638503074645996
455,244,141,159,0,0.47700002789497375,455.5,324,385,244.5,385,165,385,324,526,165,526,324,0.06587910652160645
450,245,139,157,0,0.4740000367164612,450.5,324,381,245.5,381,167,381,324,520,167,520,324,0.06658554077148438
446,248,138,159,0,0.4780000150203705,446.0,328,377,248.5,377,169,377,328,515,169,515,328,0.06747722625732422
441,250,136,159,0,0.47700002789497375,441.0,330,373,250.5,373,171,373,330,509,171,509,330,0.06578731536865234
436,251,133,156,0,0.4780000150203705,436.5,329,370,251.0,370,173,370,329,503,173,503,329,0.06665539741516113
432,251,132,155,0,0.48100003600120544,432.0,329,366,251.5,366,174,366,329,498,174,498,329,0.06643486022949219
427,252,131,153,0,0.4820000231266022,427.5,329,362,252.5,362,176,362,329,493,176,493,329,0.06687140464782715
422,253,130,152,0,0.484000027179718,422.0,329,357,253.0,357,177,357,329,487,177,487,329,0.06667685508728027
417,252,126,149,0,0.4870000183582306,417.0,327,354,252.5,354,178,354,327,480,178,480,327,0.06769919395446777
411,253,124,149,0,0.4870000183582306,411.0,328,349,253.5,349,179,349,328,473,179,473,328,0.06550240516662598
406,255,123,147,0,0.4870000183582306,406.5,329,345,255.5,345,182,345,329,468,182,468,329,0.06626605987548828
401,257,123,146,0,0.48500001430511475,401.5,330,340,257.0,340,184,340,330,463,184,463,330,0.06711769104003906
396,258,119,146,0,0.4870000183582306,396.5,331,337,258.0,337,185,337,331,456,185,456,331,0.06719565391540527
391,258,118,144,0,0.4910000264644623,391.0,330,332,258.0,332,186,332,330,450,186,450,330,0.06586360931396484
385,259,117,141,0,0.492000013589859,385.5,330,327,259.5,327,189,327,330,444,189,444,330,0.0667562484741211
379,260,115,140,0,0.0,379.5,330,322,260.0,322,190,322,330,437,190,437,330,0.06607723236083984
373,260,113,139,0,0.0,373.5,330,317,260.5,317,191,317,330,430,191,430,330,0.06703996658325195
368,261,111,138,0,0.0,368.5,330,313,261.0,313,192,313,330,424,192,424,330,0.06694507598876953
362,262,111,139,0,0.0,362.5,332,307,262.5,307,193,307,332,418,193,418,332,0.06596899032592773
356,261,109,137,0,0.0,356.5,330,302,261.5,302,193,302,330,411,193,411,330,0.0672445297241211
350,263,108,137,0,0.0,350.0,332,296,263.5,296,195,296,332,404,195,404,332,0.06579232215881348
344,264,106,136,0,0.0,344.0,332,291,264.0,291,196,291,332,397,196,397,332,0.06692957878112793
338,264,106,134,0,0.0,338.0,331,285,264.0,285,197,285,331,391,197,391,331,0.06623387336730957
331,266,104,137,0,0.4310000240802765,331.0,335,279,266.5,279,198,279,335,383,198,383,335,0.06691765785217285
325,265,103,133,0,0.43300002813339233,325.5,332,274,265.5,274,199,274,332,377,199,377,332,0.06668758392333984
318,265,103,130,0,0.43400001525878906,318.5,330,267,265.0,267,200,267,330,370,200,370,330,0.06621265411376953
312,265,102,130,0,0.4410000145435333,312.0,330,261,265.0,261,200,261,330,363,200,363,330,0.06707096099853516
306,265,100,129,0,0.44300001859664917,306.0,330,256,265.5,256,201,256,330,356,201,356,330,0.06633734703063965
299,267,100,132,0,0.4540000259876251,299.0,333,249,267.0,249,201,249,333,349,201,349,333,0.06653189659118652
294,266,100,131,0,0.4520000219345093,294.0,332,244,266.5,244,201,244,332,344,201,344,332,0.06738781929016113
287,265,99,127,0,0.46000000834465027,287.5,329,238,265.5,238,202,238,329,337,202,337,329,0.06607389450073242
282,264,98,125,0,0.4580000340938568,282.0,327,233,264.5,233,202,233,327,331,202,331,327,0.06708049774169922
277,265,98,128,0,0.0,277.0,329,228,265.0,228,201,228,329,326,201,326,329,0.06653070449829102
272,262,96,123,0,0.0,272.0,324,224,262.5,224,201,224,324,320,201,320,324,0.06647276878356934
266,261,96,122,0,0.46800002455711365,266.0,322,218,261.0,218,200,218,322,314,200,314,322,0.06653666496276855
261,261,95,121,0,0.47700002789497375,261.5,322,214,261.5,214,201,214,322,309,201,309,322,0.06594300270080566
257,260,94,120,0,0.4780000150203705,257.0,320,210,260.0,210,200,210,320,304,200,304,320,0.06837582588195801
252,260,94,120,0,0.48600003123283386,252.0,320,205,260.0,205,200,205,320,299,200,299,320,0.06517267227172852
247,259,93,118,0,0.48900002241134644,247.5,318,201,259.0,201,200,201,318,294,200,294,318,0.06654524803161621
243,258,93,118,0,0.4910000264644623,243.5,317,197,258.0,197,199,197,317,290,199,290,317,0.06689906120300293
239,258,92,118,0,0.49800002574920654,239.0,317,193,258.0,193,199,193,317,285,199,285,317,0.06607484817504883
235,256,92,117,0,0.0,235.0,315,189,256.5,189,198,189,315,281,198,281,315,0.06722903251647949
231,255,92,117,0,0.51500004529953,231.0,314,185,255.5,185,197,185,314,277,197,277,314,0.06625866889953613
227,255,91,118,0,0.0,227.5,314,182,255.0,182,196,182,314,273,196,273,314,0.06676840782165527
223,255,91,119,0,0.5470000505447388,223.5,315,178,255.5,178,196,178,315,269,196,269,315,0.06838083267211914
220,255,90,118,0,0.5590000152587891,220.0,314,175,255.0,175,196,175,314,265,196,265,314,0.06461429595947266
216,253,91,116,0,0.5670000314712524,216.5,311,171,253.0,171,195,171,311,262,195,262,311,0.06644868850708008
213,251,91,115,0,0.5710000395774841,213.5,309,168,251.5,168,194,168,309,259,194,259,309,0.06728005409240723
210,251,90,114,0,0.5730000138282776,210.0,308,165,251.0,165,194,165,308,255,194,255,308,0.06621503829956055
207,250,90,114,0,0.5770000219345093,207.0,307,162,250.0,162,193,162,307,252,193,252,307,0.06692838668823242
204,249,90,113,0,0.578000009059906,204.0,306,159,249.5,159,193,159,306,249,193,249,306,0.06611895561218262
200,248,89,113,0,0.5790000557899475,200.5,305,156,248.5,156,192,156,305,245,192,245,305,0.06624817848205566
197,247,89,111,0,0.5860000252723694,197.5,303,153,247.5,153,192,153,303,242,192,242,303,0.0672600269317627
195,247,89,113,0,0.5860000252723694,195.5,304,151,247.5,151,191,151,304,240,191,240,304,0.06661367416381836
192,251,89,123,0,0.5830000042915344,192.5,313,148,251.5,148,190,148,313,237,190,237,313,0.06663894653320312
190,252,89,126,0,0.5920000076293945,190.5,315,146,252.0,146,189,146,315,235,189,235,315,0.06686210632324219
189,252,89,126,0,0.5920000076293945,189.5,315,145,252.0,145,189,145,315,234,189,234,315,0.0651559829711914
186,250,88,122,0,0.5920000076293945,186.0,311,142,250.0,142,189,142,311,230,189,230,311,0.06734895706176758
184,247,88,119,0,0.5980000495910645,184.0,307,140,247.5,140,188,140,307,228,188,228,307,0.0674748420715332
182,244,88,114,0,0.5980000495910645,182.0,301,138,244.0,138,187,138,301,226,187,226,301,0.06638956069946289
180,243,88,114,0,0.6000000238418579,180.0,300,136,243.0,136,186,136,300,224,186,224,300,0.0666494369506836
178,245,88,120,0,0.5980000495910645,178.0,305,134,245.0,134,185,134,305,222,185,222,305,0.06636428833007812
176,246,87,122,0,0.6010000109672546,176.5,307,133,246.0,133,185,133,307,220,185,220,307,0.06640362739562988
175,246,88,122,0,0.5990000367164612,175.0,307,131,246.0,131,185,131,307,219,185,219,307,0.06662940979003906
173,242,88,117,0,0.6050000190734863,173.0,301,129,242.5,129,184,129,301,217,184,217,301,0.06682777404785156
171,242,87,116,0,0.6050000190734863,171.5,300,128,242.0,128,184,128,300,215,184,215,300,0.06698799133300781
170,239,86,113,0,0.609000027179718,170.0,296,127,239.5,127,183,127,296,213,183,213,296,0.06658530235290527
169,238,86,110,0,0.612000048160553,169.0,293,126,238.0,126,183,126,293,212,183,212,293,0.06671977043151855
167,236,87,109,0,0.609000027179718,167.5,291,124,236.5,124,182,124,291,211,182,211,291,0.06620669364929199
166,236,87,109,0,0.612000048160553,166.5,291,123,236.5,123,182,123,291,210,182,210,291,0.06648445129394531
165,235,87,109,0,0.6140000224113464,165.5,290,122,235.5,122,181,122,290,209,181,209,290,0.06725049018859863
164,235,87,109,0,0.612000048160553,164.5,290,121,235.5,121,181,121,290,208,181,208,290,0.06657004356384277
164,235,86,109,0,0.612000048160553,164.0,290,121,235.5,121,181,121,290,207,181,207,290,0.06630635261535645
163,234,86,109,0,0.6180000305175781,163.0,289,120,234.5,120,180,120,289,206,180,206,289,0.06656408309936523
162,234,86,109,0,0.6170000433921814,162.0,289,119,234.5,119,180,119,289,205,180,205,289,0.06649303436279297
162,234,86,109,0,0.6140000224113464,162.0,289,119,234.5,119,180,119,289,205,180,205,289,0.06686067581176758
161,234,86,109,0,0.6140000224113464,161.0,289,118,234.5,118,180,118,289,204,180,204,289,0.06671261787414551
160,234,87,110,0,0.6160000562667847,160.5,289,117,234.0,117,179,117,289,204,179,204,289,0.06714344024658203
160,234,87,111,0,0.6170000433921814,160.5,290,117,234.5,117,179,117,290,204,179,204,290,0.06684541702270508
160,234,86,110,0,0.6110000014305115,160.0,289,117,234.0,117,179,117,289,203,179,203,289,0.06617450714111328
160,234,86,111,0,0.6190000176429749,160.0,290,117,234.5,117,179,117,290,203,179,203,290,0.06606197357177734
160,234,86,110,0,0.6180000305175781,160.0,289,117,234.0,117,179,117,289,203,179,203,289,0.06718277931213379
160,234,86,110,0,0.6160000562667847,160.0,289,117,234.0,117,179,117,289,203,179,203,289,0.06710696220397949
160,234,86,110,0,0.612000048160553,160.0,289,117,234.0,117,179,117,289,203,179,203,289,0.0660402774810791
160,234,86,110,0,0.6200000047683716,160.0,289,117,234.0,117,179,117,289,203,179,203,289,0.0659477710723877
160,234,87,110,0,0.6110000014305115,160.5,289,117,234.0,117,179,117,289,204,179,204,289,0.06700706481933594
161,234,86,110,0,0.6170000433921814,161.0,289,118,234.0,118,179,118,289,204,179,204,289,0.06654167175292969
161,234,87,110,0,0.6180000305175781,161.5,289,118,234.0,118,179,118,289,205,179,205,289,0.06675982475280762
162,234,87,110,0,0.6190000176429749,162.5,289,119,234.0,119,179,119,289,206,179,206,289,0.0666816234588623
163,233,86,109,0,0.6200000047683716,163.0,288,120,233.5,120,179,120,288,206,179,206,288,0.06669116020202637
164,234,86,108,0,0.6160000562667847,164.0,288,121,234.0,121,180,121,288,207,180,207,288,0.0667264461517334
165,234,86,108,0,0.6140000224113464,165.0,288,122,234.0,122,180,122,288,208,180,208,288,0.06585407257080078
166,234,86,108,0,0.6160000562667847,166.0,288,123,234.0,123,180,123,288,209,180,209,288,0.06681323051452637
168,234,86,109,0,0.6170000433921814,168.0,289,125,234.5,125,180,125,289,211,180,211,289,0.06831669807434082
169,235,85,111,0,0.6140000224113464,169.5,291,127,235.5,127,180,127,291,212,180,212,291,0.06490159034729004
171,236,86,113,0,0.6140000224113464,171.0,293,128,236.5,128,180,128,293,214,180,214,293,0.06679224967956543
173,237,86,112,0,0.6170000433921814,173.0,293,130,237.0,130,181,130,293,216,181,216,293,0.06611180305480957
175,237,86,112,0,0.6040000319480896,175.0,293,132,237.0,132,181,132,293,218,181,218,293,0.06654524803161621
177,236,86,110,0,0.6110000014305115,177.0,291,134,236.0,134,181,134,291,220,181,220,291,0.06811952590942383
179,235,86,109,0,0.6140000224113464,179.0,290,136,235.5,136,181,136,290,222,181,222,290,0.06535172462463379
181,235,86,108,0,0.6140000224113464,181.0,289,138,235.0,138,181,138,289,224,181,224,289,0.06688928604125977
184,235,86,109,0,0.6140000224113464,184.0,290,141,235.5,141,181,141,290,227,181,227,290,0.06632637977600098
186,236,85,110,0,0.6140000224113464,186.5,291,144,236.0,144,181,144,291,229,181,229,291,0.06692862510681152
189,236,86,111,0,0.612000048160553,189.0,292,146,236.5,146,181,146,292,232,181,232,292,0.06664252281188965
192,236,86,110,0,0.6020000576972961,192.0,291,149,236.0,149,181,149,291,235,181,235,291,0.06619811058044434
195,236,86,110,0,0.6110000014305115,195.0,291,152,236.0,152,181,152,291,238,181,238,291,0.06838655471801758
198,236,86,109,0,0.6030000448226929,198.0,291,155,236.5,155,182,155,291,241,182,241,291,0.06509065628051758
201,236,86,109,0,0.6170000433921814,201.0,291,158,236.5,158,182,158,291,244,182,244,291,0.06594204902648926
205,237,86,110,0,0.6020000576972961,205.0,292,162,237.0,162,182,162,292,248,182,248,292,0.06725740432739258
208,236,87,109,0,0.5990000367164612,208.5,291,165,236.5,165,182,165,291,252,182,252,291,0.06632065773010254
212,236,87,109,0,0.0,212.5,291,169,236.5,169,182,169,291,256,182,256,291,0.06739044189453125
216,236,86,109,0,0.0,216.0,291,173,236.5,173,182,173,291,259,182,259,291,0.06580305099487305
220,237,86,111,0,0.0,220.0,293,177,237.5,177,182,177,293,263,182,263,293,0.06736183166503906
224,237,86,111,0,0.0,224.0,293,181,237.5,181,182,181,293,267,182,267,293,0.06601428985595703
229,237,86,111,0,0.0,229.0,293,186,237.5,186,182,186,293,272,182,272,293,0.06633853912353516
233,237,86,111,0,0.0,233.0,293,190,237.5,190,182,190,293,276,182,276,293,0.06670188903808594
238,239,86,113,0,0.5400000214576721,238.0,296,195,239.5,195,183,195,296,281,183,281,296,0.06656289100646973
243,239,86,112,0,0.5400000214576721,243.0,295,200,239.0,200,183,200,295,286,183,286,295,0.06679320335388184
248,238,86,112,0,0.0,248.0,294,205,238.0,205,182,205,294,291,182,291,294,0.06702327728271484
253,238,87,113,0,0.0,253.5,295,210,238.5,210,182,210,295,297,182,297,295,0.0654764175415039
259,238,86,113,0,0.0,259.0,295,216,238.5,216,182,216,295,302,182,302,295,0.06727790832519531
264,239,87,114,0,0.550000011920929,264.5,296,221,239.0,221,182,221,296,308,182,308,296,0.06638813018798828
270,238,87,113,0,0.5610000491142273,270.5,295,227,238.5,227,182,227,295,314,182,314,295,0.06673860549926758
276,238,86,113,0,0.5750000476837158,276.0,295,233,238.5,233,182,233,295,319,182,319,295,0.06648087501525879
282,237,87,113,0,0.5770000219345093,282.5,294,239,237.5,239,181,239,294,326,181,326,294,0.06608080863952637
288,237,87,113,0,0.5770000219345093,288.5,294,245,237.5,245,181,245,294,332,181,332,294,0.06722068786621094
294,237,87,113,0,0.5750000476837158,294.5,294,251,237.5,251,181,251,294,338,181,338,294,0.06643104553222656
301,236,87,113,0,0.5670000314712524,301.5,293,258,236.5,258,180,258,293,345,180,345,293,0.06667804718017578
308,236,87,113,0,0.5660000443458557,308.5,293,265,236.5,265,180,265,293,352,180,352,293,0.06664848327636719
315,236,87,113,0,0.5830000042915344,315.5,293,272,236.5,272,180,272,293,359,180,359,293,0.06691908836364746
323,235,88,112,0,0.0,323.0,291,279,235.0,279,179,279,291,367,179,367,291,0.06637406349182129
330,235,88,112,0,0.0,330.0,291,286,235.0,286,179,286,291,374,179,374,291,0.06694626808166504
337,234,88,113,0,0.0,337.0,291,293,234.5,293,178,293,291,381,178,381,291,0.06653094291687012
343,234,89,114,0,0.0,343.5,291,299,234.0,299,177,299,291,388,177,388,291,0.06689763069152832
350,234,89,114,0,0.0,350.5,291,306,234.0,306,177,306,291,395,177,395,291,0.06732392311096191
357,233,90,113,0,0.0,357.0,290,312,233.5,312,177,312,290,402,177,402,290,0.06551551818847656
363,232,89,115,0,0.0,363.5,290,319,232.5,319,175,319,290,408,175,408,290,0.06667447090148926
369,232,91,114,0,0.0,369.5,289,324,232.0,324,175,324,289,415,175,415,289,0.0664205551147461
375,231,91,115,0,0.0,375.5,289,330,231.5,330,174,330,289,421,174,421,289,0.06716227531433105
381,230,91,115,0,0.6320000290870667,381.5,288,336,230.5,336,173,336,288,427,173,427,288,0.0671694278717041
387,230,92,114,0,0.6300000548362732,387.0,287,341,230.0,341,173,341,287,433,173,433,287,0.06578874588012695
392,230,93,116,0,0.6260000467300415,392.5,288,346,230.0,346,172,346,288,439,172,439,288,0.06607842445373535
398,228,94,115,0,0.6370000243186951,398.0,286,351,228.5,351,171,351,286,445,171,445,286,0.06673145294189453
403,227,94,115,0,0.6330000162124634,403.0,285,356,227.5,356,170,356,285,450,170,450,285,0.06655192375183105
408,227,96,115,0,0.6360000371932983,408.0,285,360,227.5,360,170,360,285,456,170,456,285,0.06678032875061035
412,229,97,120,0,0.6340000033378601,412.5,289,364,229.0,364,169,364,289,461,169,461,289,0.06625556945800781
418,226,98,116,0,0.6410000324249268,418.0,284,369,226.0,369,168,369,284,467,168,467,284,0.0668797492980957
422,225,98,117,0,0.6310000419616699,422.0,284,373,225.5,373,167,373,284,471,167,471,284,0.06756854057312012
426,225,99,119,0,0.6420000195503235,426.5,285,377,225.5,377,166,377,285,476,166,476,285,0.06545758247375488
431,225,99,120,0,0.6350000500679016,431.5,285,382,225.0,382,165,382,285,481,165,481,285,0.0668027400970459
436,226,100,124,0,0.6390000581741333,436.0,288,386,226.0,386,164,386,288,486,164,486,288,0.0663917064666748
439,224,101,120,0,0.6420000195503235,439.5,284,389,224.0,389,164,389,284,490,164,490,284,0.06691789627075195
444,224,102,122,0,0.6380000114440918,444.0,285,393,224.0,393,163,393,285,495,163,495,285,0.06669735908508301
448,224,102,122,0,0.6380000114440918,448.0,285,397,224.0,397,163,397,285,499,163,499,285,0.06644439697265625
451,222,102,121,0,0.6410000324249268,451.0,283,400,222.5,400,162,400,283,502,162,502,283,0.06699609756469727
455,221,104,120,0,0.6490000486373901,455.0,281,403,221.0,403,161,403,281,507,161,507,281,0.06649994850158691
458,220,104,119,0,0.6450000405311584,458.0,280,406,220.5,406,161,406,280,510,161,510,280,0.06656885147094727
462,219,104,119,0,0.6440000534057617,462.0,279,410,219.5,410,160,410,279,514,160,514,279,0.06683731079101562
464,219,105,121,0,0.6440000534057617,464.5,280,412,219.5,412,159,412,280,517,159,517,280,0.06731104850769043
467,218,105,119,0,0.6540000438690186,467.5,278,415,218.5,415,159,415,278,520,159,520,278,0.06602048873901367
470,218,105,120,0,0.6510000228881836,470.5,278,418,218.0,418,158,418,278,523,158,523,278,0.06577801704406738
472,216,107,119,0,0.6520000100135803,472.5,276,419,216.5,419,157,419,276,526,157,526,276,0.06778430938720703
475,217,107,121,0,0.6550000309944153,475.5,278,422,217.5,422,157,422,278,529,157,529,278,0.06614470481872559
477,218,107,124,0,0.656000018119812,477.5,280,424,218.0,424,156,424,280,531,156,531,280,0.06634807586669922
480,218,106,125,0,0.6530000567436218,480.0,281,427,218.5,427,156,427,281,533,156,533,281,0.06692957878112793
481,218,107,127,0,0.6510000228881836,481.5,282,428,218.5,428,155,428,282,535,155,535,282,0.0662992000579834
483,216,107,123,0,0.6550000309944153,483.5,278,430,216.5,430,155,430,278,537,155,537,278,0.06676578521728516
485,216,107,122,0,0.6550000309944153,485.5,277,432,216.0,432,155,432,277,539,155,539,277,0.06635260581970215
487,214,108,121,0,0.6550000309944153,487.0,275,433,214.5,433,154,433,275,541,154,541,275,0.06661152839660645
488,215,107,122,0,0.6650000214576721,488.5,276,435,215.0,435,154,435,276,542,154,542,276,0.06689286231994629
490,218,108,129,0,0.6570000052452087,490.0,283,436,218.5,436,154,436,283,544,154,544,283,0.06682419776916504
491,217,108,128,0,0.6530000567436218,491.0,281,437,217.0,437,153,437,281,545,153,545,281,0.06792593002319336
492,218,108,131,0,0.6640000343322754,492.0,284,438,218.5,438,153,438,284,546,153,546,284,0.06530308723449707
493,219,108,132,0,0.6570000052452087,493.0,285,439,219.0,439,153,439,285,547,153,547,285,0.06625890731811523
493,219,109,132,0,0.6570000052452087,493.5,285,439,219.0,439,153,439,285,548,153,548,285,0.06691551208496094
493,219,109,133,0,0.6500000357627869,493.5,286,439,219.5,439,153,439,286,548,153,548,286,0.06746768951416016
493,219,109,133,0,0.6600000262260437,493.5,286,439,219.5,439,153,439,286,548,153,548,286,0.0655369758605957
494,219,110,133,0,0.6540000438690186,494.0,286,439,219.5,439,153,439,286,549,153,549,286,0.06629586219787598
493,219,109,132,0,0.6650000214576721,493.5,285,439,219.0,439,153,439,285,548,153,548,285,0.0665888786315918
494,220,110,134,0,0.6610000133514404,494.0,287,439,220.0,439,153,439,287,549,153,549,287,0.06733107566833496
494,220,110,134,0,0.6520000100135803,494.0,287,439,220.0,439,153,439,287,549,153,549,287,0.06604504585266113
494,220,110,134,0,0.6490000486373901,494.0,287,439,220.0,439,153,439,287,549,153,549,287,0.06699609756469727
494,220,110,134,0,0.6530000567436218,494.0,287,439,220.0,439,153,439,287,549,153,549,287,0.06633734703063965
493,219,109,133,0,0.6490000486373901,493.5,286,439,219.5,439,153,439,286,548,153,548,286,0.06607365608215332
493,219,109,133,0,0.6520000100135803,493.5,286,439,219.5,439,153,439,286,548,153,548,286,0.0675802230834961
493,219,108,132,0,0.6520000100135803,493.0,285,439,219.0,439,153,439,285,547,153,547,285,0.06651902198791504
492,217,109,129,0,0.6450000405311584,492.5,282,438,217.5,438,153,438,282,547,153,547,282,0.06598567962646484
492,217,109,126,0,0.6480000019073486,492.5,280,438,217.0,438,154,438,280,547,154,547,280,0.06690478324890137
491,216,109,124,0,0.6530000567436218,491.5,278,437,216.0,437,154,437,278,546,154,546,278,0.06647729873657227
490,216,109,125,0,0.6530000567436218,490.5,279,436,216.5,436,154,436,279,545,154,545,279,0.0699312686920166
490,218,109,128,0,0.64000004529953,490.5,282,436,218.0,436,154,436,282,545,154,545,282,0.06340813636779785
490,218,110,128,0,0.6490000486373901,490.0,282,435,218.0,435,154,435,282,545,154,545,282,0.06651520729064941
489,219,110,131,0,0.6470000147819519,489.0,285,434,219.5,434,154,434,285,544,154,544,285,0.06668424606323242
489,220,110,132,0,0.6490000486373901,489.0,286,434,220.0,434,154,434,286,544,154,544,286,0.06651782989501953
487,216,109,122,0,0.6470000147819519,487.5,277,433,216.0,433,155,433,277,542,155,542,277,0.06654977798461914
487,217,110,124,0,0.6510000228881836,487.0,279,432,217.0,432,155,432,279,542,155,542,279,0.06679558753967285
486,216,110,123,0,0.64000004529953,486.0,278,431,216.5,431,155,431,278,541,155,541,278,0.0669701099395752
485,217,110,125,0,0.6430000066757202,485.0,280,430,217.5,430,155,430,280,540,155,540,280,0.06777262687683105
484,217,110,122,0,0.6380000114440918,484.0,278,429,217.0,429,156,429,278,539,156,539,278,0.06486153602600098
483,217,110,122,0,0.6360000371932983,483.0,278,428,217.0,428,156,428,278,538,156,538,278,0.06700468063354492
481,220,111,127,0,0.6310000419616699,481.5,284,426,220.5,426,157,426,284,537,157,537,284,0.06640243530273438
481,222,110,131,0,0.6390000581741333,481.0,288,426,222.5,426,157,426,288,536,157,536,288,0.06637406349182129
479,221,110,129,0,0.6350000500679016,479.0,286,424,221.5,424,157,424,286,534,157,534,286,0.06698083877563477
478,221,110,127,0,0.6330000162124634,478.0,285,423,221.5,423,158,423,285,533,158,533,285,0.06638240814208984
477,225,110,133,0,0.6230000257492065,477.0,292,422,225.5,422,159,422,292,532,159,532,292,0.06698441505432129
476,223,110,128,0,0.6270000338554382,476.0,287,421,223.0,421,159,421,287,531,159,531,287,0.06601071357727051
474,223,110,128,0,0.6220000386238098,474.0,287,419,223.0,419,159,419,287,529,159,529,287,0.0664513111114502
473,224,110,128,0,0.6200000047683716,473.0,288,418,224.0,418,160,418,288,528,160,528,288,0.06734418869018555
471,223,111,125,0,0.6260000467300415,471.5,286,416,223.5,416,161,416,286,527,161,527,286,0.06579017639160156
470,224,110,125,0,0.6220000386238098,470.0,287,415,224.5,415,162,415,287,525,162,525,287,0.06702828407287598
468,226,111,129,0,0.6190000176429749,468.5,291,413,226.5,413,162,413,291,524,162,524,291,0.0671234130859375
466,229,111,133,0,0.6150000095367432,466.5,296,411,229.5,411,163,411,296,522,163,522,296,0.06614375114440918
465,232,110,136,0,0.6060000061988831,465.0,300,410,232.0,410,164,410,300,520,164,520,300,0.06621980667114258
463,233,111,137,0,0.6070000529289246,463.5,302,408,233.5,408,165,408,302,519,165,519,302,0.0673823356628418
460,230,111,129,0,0.612000048160553,460.5,295,405,230.5,405,166,405,295,516,166,516,295,0.0660557746887207
458,229,110,125,0,0.6020000576972961,458.0,292,403,229.5,403,167,403,292,513,167,513,292,0.0666506290435791
456,232,111,128,0,0.6050000190734863,456.5,296,401,232.0,401,168,401,296,512,168,512,296,0.06747722625732422
454,235,111,132,0,0.5950000286102295,454.5,301,399,235.0,399,169,399,301,510,169,510,301,0.06576848030090332
451,237,111,134,0,0.5940000414848328,451.5,304,396,237.0,396,170,396,304,507,170,507,304,0.06658411026000977
448,239,111,134,0,0.5860000252723694,448.5,306,393,239.0,393,172,393,306,504,172,504,306,0.06687164306640625
446,240,111,132,0,0.578000009059906,446.5,306,391,240.0,391,174,391,306,502,174,502,306,0.06639313697814941
444,239,110,128,0,0.581000030040741,444.0,303,389,239.0,389,175,389,303,499,175,499,303,0.06626701354980469
441,240,110,128,0,0.581000030040741,441.0,304,386,240.0,386,176,386,304,496,176,496,304,0.06685471534729004
438,241,110,127,0,0.5820000171661377,438.0,305,383,241.5,383,178,383,305,493,178,493,305,0.0666496753692627
435,242,111,127,0,0.5740000009536743,435.5,306,380,242.5,380,179,380,306,491,179,491,306,0.06648087501525879
432,244,110,127,0,0.5730000138282776,432.0,308,377,244.5,377,181,377,308,487,181,487,308,0.0668179988861084
428,247,109,128,0,0.5649999976158142,428.5,311,374,247.0,374,183,374,311,483,183,483,311,0.06647610664367676
425,250,109,128,0,0.5630000233650208,425.5,314,371,250.0,371,186,371,314,480,186,480,314,0.06663751602172852
422,250,109,127,0,0.5590000152587891,422.5,314,368,250.5,368,187,368,314,477,187,477,314,0.06671500205993652
418,253,110,128,0,0.5530000329017639,418.0,317,363,253.0,363,189,363,317,473,189,473,317,0.06605100631713867
414,255,108,129,0,0.5480000376701355,414.0,320,360,255.5,360,191,360,320,468,191,468,320,0.06715059280395508
410,258,109,128,0,0.5440000295639038,410.5,322,356,258.0,356,194,356,322,465,194,465,322,0.0666661262512207
406,261,109,132,0,0.5370000004768372,406.5,327,352,261.0,352,195,352,327,461,195,461,327,0.06661272048950195
402,266,109,137,0,0.5330000519752502,402.5,335,348,266.5,348,198,348,335,457,198,457,335,0.06682038307189941
398,267,109,132,0,0.531000018119812,398.5,333,344,267.0,344,201,344,333,453,201,453,333,0.06618070602416992
394,268,107,131,0,0.527999997138977,394.5,334,341,268.5,341,203,341,334,448,203,448,334,0.06691193580627441
390,271,107,131,0,0.5220000147819519,390.5,337,337,271.5,337,206,337,337,444,206,444,337,0.06650733947753906
386,273,107,130,0,0.5130000114440918,386.5,338,333,273.0,333,208,333,338,440,208,440,338,0.06657576560974121
382,275,108,131,0,0.503000020980835,382.0,341,328,275.5,328,210,328,341,436,210,436,341,0.06682300567626953
378,279,107,134,0,0.4970000088214874,378.5,346,325,279.0,325,212,325,346,432,212,432,346,0.06609153747558594
374,281,107,132,0,0.4910000264644623,374.5,347,321,281.0,321,215,321,347,428,215,428,347,0.06801152229309082
370,283,107,132,0,0.4870000183582306,370.5,349,317,283.0,317,217,317,349,424,217,424,349,0.06568312644958496
366,285,108,131,0,0.0,366.0,351,312,285.5,312,220,312,351,420,220,420,351,0.06644892692565918
362,287,106,131,0,0.49000000953674316,362.0,353,309,287.5,309,222,309,353,415,222,415,353,0.06708168983459473
358,290,107,132,0,0.4870000183582306,358.5,356,305,290.0,305,224,305,356,412,224,412,356,0.06582903861999512
354,292,107,133,0,0.4820000231266022,354.5,359,301,292.5,301,226,301,359,408,226,408,359,0.06710171699523926
350,294,107,133,0,0.48500001430511475,350.5,361,297,294.5,297,228,297,361,404,228,404,361,0.06687521934509277
346,296,107,131,0,0.484000027179718,346.5,362,293,296.5,293,231,293,362,400,231,400,362,0.06573176383972168
342,300,107,132,0,0.48100003600120544,342.5,366,289,300.0,289,234,289,366,396,234,396,366,0.06785011291503906
339,301,108,132,0,0.4750000238418579,339.0,367,285,301.0,285,235,285,367,393,235,393,367,0.06554889678955078
335,302,107,133,0,0.4750000238418579,335.5,369,282,302.5,282,236,282,369,389,236,389,369,0.0669715404510498
331,305,107,134,0,0.4780000150203705,331.5,372,278,305.0,278,238,278,372,385,238,385,372,0.0678865909576416
327,307,108,134,0,0.4750000238418579,327.0,374,273,307.0,273,240,273,374,381,240,381,374,0.06476521492004395
323,309,107,134,0,0.47600001096725464,323.5,376,270,309.0,270,242,270,376,377,242,377,376,0.06706976890563965
320,311,108,134,0,0.4740000367164612,320.0,378,266,311.0,266,244,266,378,374,244,374,378,0.06656765937805176
317,313,108,134,0,0.4790000319480896,317.0,380,263,313.0,263,246,263,380,371,246,371,380,0.0684506893157959
313,315,108,133,0,0.0,313.0,382,259,315.5,259,249,259,382,367,249,367,382,0.06484746932983398
310,317,108,134,0,0.4570000171661377,310.0,384,256,317.0,256,250,256,384,364,250,364,384,0.06808757781982422
306,318,109,135,0,0.4490000307559967,306.5,386,252,318.5,252,251,252,386,361,251,361,386,0.06589436531066895
304,320,108,134,0,0.4520000219345093,304.0,387,250,320.0,250,253,250,387,358,253,358,387,0.06559371948242188
301,322,108,136,0,0.445000022649765,301.0,390,247,322.0,247,254,247,390,355,254,355,390,0.0670166015625
298,325,109,140,0,0.4490000307559967,298.5,395,244,325.0,244,255,244,395,353,255,353,395,0.06605935096740723
295,325,109,137,0,0.4440000355243683,295.5,394,241,325.5,241,257,241,394,350,257,350,394,0.06692123413085938
292,325,110,135,0,0.44200003147125244,292.0,393,237,325.5,237,258,237,393,347,258,347,393,0.06687283515930176
289,326,111,135,0,0.4350000321865082,289.5,394,234,326.5,234,259,234,394,345,259,345,394,0.06575798988342285
287,327,110,135,0,0.43800002336502075,287.0,395,232,327.5,232,260,232,395,342,260,342,395,0.06705689430236816
285,329,110,135,0,0.4410000145435333,285.0,397,230,329.5,230,262,230,397,340,262,340,397,0.06635522842407227
282,330,110,135,0,0.4410000145435333,282.0,398,227,330.5,227,263,227,398,337,263,337,398,0.06646919250488281
280,331,111,135,0,0.4390000104904175,280.5,399,225,331.5,225,264,225,399,336,264,336,399,0.0667576789855957
278,332,112,135,0,0.4390000104904175,278.0,400,222,332.5,222,265,222,400,334,265,334,400,0.06649255752563477
276,333,111,135,0,0.4410000145435333,276.5,401,221,333.5,221,266,221,401,332,266,332,401,0.06693673133850098
275,334,112,136,0,0.4390000104904175,275.0,402,219,334.0,219,266,219,402,331,266,331,402,0.06646299362182617
273,335,111,136,0,0.4410000145435333,273.5,403,218,335.0,218,267,218,403,329,267,329,403,0.06622791290283203
272,336,110,136,0,0.4410000145435333,272.0,404,217,336.0,217,268,217,404,327,268,327,404,0.0671839714050293
270,337,111,136,0,0.4410000145435333,270.5,405,215,337.0,215,269,215,405,326,269,326,405,0.0659172534942627
268,338,111,136,0,0.4400000274181366,268.5,406,213,338.0,213,270,213,406,324,270,324,406,0.06719660758972168
267,338,111,136,0,0.43800002336502075,267.5,406,212,338.0,212,270,212,406,323,270,323,406,0.06664109230041504
266,338,112,136,0,0.4390000104904175,266.0,406,210,338.0,210,270,210,406,322,270,322,406,0.06577801704406738
265,339,111,137,0,0.4400000274181366,265.5,408,210,339.5,210,271,210,408,321,271,321,408,0.06721234321594238
264,339,111,137,0,0.4400000274181366,264.5,408,209,339.5,209,271,209,408,320,271,320,408,0.06655216217041016
264,340,112,136,0,0.44200003147125244,264.0,408,208,340.0,208,272,208,408,320,272,320,408,0.06670641899108887
263,340,111,136,0,0.44300001859664917,263.5,408,208,340.0,208,272,208,408,319,272,319,408,0.06613922119140625
263,339,112,137,0,0.43800002336502075,263.0,408,207,339.5,207,271,207,408,319,271,319,408,0.06705188751220703
263,339,112,137,0,0.43800002336502075,263.0,408,207,339.5,207,271,207,408,319,271,319,408,0.06706953048706055
263,340,112,136,0,0.4410000145435333,263.0,408,207,340.0,207,272,207,408,319,272,319,408,0.06589674949645996
263,339,112,137,0,0.43800002336502075,263.0,408,207,339.5,207,271,207,408,319,271,319,408,0.06640744209289551
262,339,113,137,0,0.43700000643730164,262.5,408,206,339.5,206,271,206,408,319,271,319,408,0.06732177734375
263,340,112,136,0,0.44200003147125244,263.0,408,207,340.0,207,272,207,408,319,272,319,408,0.0659334659576416
262,339,113,137,0,0.43800002336502075,262.5,408,206,339.5,206,271,206,408,319,271,319,408,0.06676578521728516
263,339,112,137,0,0.43700000643730164,263.0,408,207,339.5,207,271,207,408,319,271,319,408,0.06644773483276367
263,339,112,137,0,0.43700000643730164,263.0,408,207,339.5,207,271,207,408,319,271,319,408,0.06743788719177246
263,339,113,137,0,0.43800002336502075,263.5,408,207,339.5,207,271,207,408,320,271,320,408,0.06638360023498535
263,339,113,138,0,0.43800002336502075,263.5,408,207,339.0,207,270,207,408,320,270,320,408,0.06616640090942383
263,339,113,138,0,0.4390000104904175,263.5,408,207,339.0,207,270,207,408,320,270,320,408,0.06735944747924805
263,339,113,139,0,0.4400000274181366,263.5,409,207,339.5,207,270,207,409,320,270,320,409,0.06554293632507324
264,338,113,139,0,0.4350000321865082,264.5,408,208,338.5,208,269,208,408,321,269,321,408,0.06728839874267578
264,340,113,145,0,0.4400000274181366,264.5,413,208,340.5,208,268,208,413,321,268,321,413,0.06671357154846191
264,338,113,141,0,0.4350000321865082,264.5,409,208,338.5,208,268,208,409,321,268,321,409,0.06631112098693848
265,339,114,145,0,0.43700000643730164,265.0,412,208,339.5,208,267,208,412,322,267,322,412,0.06661152839660645
265,339,114,147,0,0.43300002813339233,265.0,413,208,339.5,208,266,208,413,322,266,322,413,0.06683850288391113
266,338,114,146,0,0.4310000240802765,266.0,411,209,338.0,209,265,209,411,323,265,323,411,0.06590867042541504
266,335,114,142,0,0.42600002884864807,266.0,406,209,335.0,209,264,209,406,323,264,323,406,0.0671079158782959
266,334,115,142,0,0.4220000207424164,266.5,405,209,334.0,209,263,209,405,324,263,324,405,0.0668182373046875
266,332,115,141,0,0.4180000126361847,266.5,403,209,332.5,209,262,209,403,324,262,324,403,0.06795907020568848
266,331,115,142,0,0.4150000214576721,266.5,402,209,331.0,209,260,209,402,324,260,324,402,0.06567025184631348
267,331,116,144,0,0.4130000174045563,267.0,403,209,331.0,209,259,209,403,325,259,325,403,0.06649518013000488
267,330,117,144,0,0.4140000343322754,267.5,402,209,330.0,209,258,209,402,326,258,326,402,0.06606554985046387
268,329,117,144,0,0.40800002217292786,268.5,401,210,329.0,210,257,210,401,327,257,327,401,0.06736087799072266
269,327,118,143,0,0.4050000309944153,269.0,399,210,327.5,210,256,210,399,328,256,328,399,0.0659799575805664
269,326,119,144,0,0.4020000100135803,269.5,398,210,326.0,210,254,210,398,329,254,329,398,0.06695103645324707
269,325,119,145,0,0.4020000100135803,269.5,398,210,325.5,210,253,210,398,329,253,329,398,0.06671142578125
270,323,120,146,0,0.39500001072883606,270.0,396,210,323.0,210,250,210,396,330,250,330,396,0.06834745407104492
270,321,119,146,0,0.39100003242492676,270.5,394,211,321.0,211,248,211,394,330,248,330,394,0.0649418830871582
271,320,119,147,0,0.38700002431869507,271.5,394,212,320.5,212,247,212,394,331,247,331,394,0.06581234931945801
271,319,121,149,0,0.3840000033378601,271.5,394,211,319.5,211,245,211,394,332,245,332,394,0.06716346740722656
271,317,121,150,0,0.38200002908706665,271.5,392,211,317.0,211,242,211,392,332,242,332,392,0.06689286231994629
272,316,122,151,0,0.3790000081062317,272.0,392,211,316.5,211,241,211,392,333,241,333,392,0.0661306381225586
272,317,123,157,0,0.3800000250339508,272.5,396,211,317.5,211,239,211,396,334,239,334,396,0.06781554222106934
273,312,123,153,0,0.3710000216960907,273.5,389,212,312.5,212,236,212,389,335,236,335,389,0.06665325164794922
274,309,124,153,0,0.36900001764297485,274.0,386,212,309.5,212,233,212,386,336,233,336,386,0.06528782844543457
274,307,125,154,0,0.3630000054836273,274.5,384,212,307.0,212,230,212,384,337,230,337,384,0.06623172760009766
274,305,125,155,0,0.3580000102519989,274.5,383,212,305.5,212,228,212,383,337,228,337,383,0.06685280799865723
275,303,126,157,0,0.35600000619888306,275.0,382,212,303.5,212,225,212,382,338,225,338,382,0.06669735908508301
275,301,127,156,0,0.34800001978874207,275.5,379,212,301.0,212,223,212,379,339,223,339,379,0.06665182113647461
276,298,128,158,0,0.3450000286102295,276.0,377,212,298.0,212,219,212,377,340,219,340,377,0.06663656234741211
276,295,129,160,0,0.3370000123977661,276.5,375,212,295.0,212,215,212,375,341,215,341,375,0.06696891784667969
277,292,131,161,0,0.33400002121925354,277.5,373,212,292.5,212,212,212,373,343,212,343,373,0.06646561622619629
277,289,131,161,0,0.328000009059906,277.5,370,212,289.5,212,209,212,370,343,209,343,370,0.06656026840209961
277,286,133,162,0,0.32600000500679016,277.5,367,211,286.0,211,205,211,367,344,205,344,367,0.06667804718017578
277,284,133,164,0,0.328000009059906,277.5,366,211,284.0,211,202,211,366,344,202,344,366,0.06662940979003906
278,282,134,168,0,0.32100000977516174,278.0,366,211,282.0,211,198,211,366,345,198,345,366,0.06657576560974121
279,279,134,166,0,0.3190000057220459,279.0,362,212,279.0,212,196,212,362,346,196,346,362,0.0665748119354248
279,279,136,172,0,0.31800001859664917,279.0,365,211,279.0,211,193,211,365,347,193,347,365,0.0670461654663086
279,274,136,168,0,0.0,279.0,358,211,274.0,211,190,211,358,347,190,347,358,0.06646919250488281
279,271,137,168,0,0.0,279.5,355,211,271.0,211,187,211,355,348,187,348,355,0.0669097900390625
279,268,137,169,0,0.0,279.5,353,211,268.5,211,184,211,353,348,184,348,353,0.06621479988098145
280,266,138,172,0,0.0,280.0,352,211,266.0,211,180,211,352,349,180,349,352,0.06686782836914062
279,263,139,173,0,0.0,279.5,350,210,263.5,210,177,210,350,349,177,349,350,0.06679320335388184
280,262,140,174,0,0.0,280.0,349,210,262.0,210,175,210,349,350,175,350,349,0.06595039367675781
280,259,140,174,0,0.0,280.0,346,210,259.0,210,172,210,346,350,172,350,346,0.06748533248901367
279,256,141,175,0,0.3760000169277191,279.5,344,209,256.5,209,169,209,344,350,169,350,344,0.06594681739807129
280,255,142,176,0,0.0,280.0,343,209,255.0,209,167,209,343,351,167,351,343,0.06619119644165039
280,252,142,177,0,0.0,280.0,341,209,252.5,209,164,209,341,351,164,351,341,0.06727170944213867
280,249,142,177,0,0.0,280.0,338,209,249.5,209,161,209,338,351,161,351,338,0.06587886810302734
280,248,144,177,0,0.0,280.0,337,208,248.5,208,160,208,337,352,160,352,337,0.06723237037658691
280,247,144,179,0,0.0,280.0,337,208,247.5,208,158,208,337,352,158,352,337,0.06668400764465332
280,245,144,181,0,0.0,280.0,336,208,245.5,208,155,208,336,352,155,352,336,0.06593585014343262
279,243,145,181,0,0.0,279.5,334,207,243.5,207,153,207,334,352,153,352,334,0.06709742546081543
279,242,145,182,0,0.3700000047683716,279.5,333,207,242.0,207,151,207,333,352,151,352,333,0.06638717651367188
279,240,145,182,0,0.3700000047683716,279.5,331,207,240.0,207,149,207,331,352,149,352,331,0.06659865379333496
279,238,147,182,0,0.0,279.5,329,206,238.0,206,147,206,329,353,147,353,329,0.06664156913757324
279,236,147,183,0,0.0,279.5,328,206,236.5,206,145,206,328,353,145,353,328,0.06653308868408203
279,236,147,184,0,0.0,279.5,328,206,236.0,206,144,206,328,353,144,353,328,0.06791281700134277
279,234,148,183,0,0.35500001907348633,279.0,326,205,234.5,205,143,205,326,353,143,353,326,0.06536626815795898
279,234,148,184,0,0.3570000231266022,279.0,326,205,234.0,205,142,205,326,353,142,353,326,0.06696891784667969
279,232,149,185,0,0.35600000619888306,279.5,325,205,232.5,205,140,205,325,354,140,354,325,0.06622815132141113
279,231,149,184,0,0.35500001907348633,279.5,323,205,231.0,205,139,205,323,354,139,354,323,0.06692028045654297
279,230,149,185,0,0.35100001096725464,279.5,323,205,230.5,205,138,205,323,354,138,354,323,0.06634664535522461
279,230,149,186,0,0.35500001907348633,279.5,323,205,230.0,205,137,205,323,354,137,354,323,0.06607627868652344
279,228,150,185,0,0.34800001978874207,279.0,321,204,228.5,204,136,204,321,354,136,354,321,0.06757545471191406
279,228,150,185,0,0.35100001096725464,279.0,321,204,228.5,204,136,204,321,354,136,354,321,0.06631970405578613
278,228,151,186,0,0.3460000157356262,278.5,321,203,228.0,203,135,203,321,354,135,354,321,0.06625080108642578
278,227,151,187,0,0.34700000286102295,278.5,321,203,227.5,203,134,203,321,354,134,354,321,0.06669330596923828
278,227,151,186,0,0.3490000069141388,278.5,320,203,227.0,203,134,203,320,354,134,354,320,0.06674933433532715
279,227,150,186,0,0.0,279.0,320,204,227.0,204,134,204,320,354,134,354,320,0.06661057472229004
278,227,151,186,0,0.0,278.5,320,203,227.0,203,134,203,320,354,134,354,320,0.06693077087402344
278,226,151,187,0,0.3460000157356262,278.5,320,203,226.5,203,133,203,320,354,133,354,320,0.06615781784057617
278,226,151,187,0,0.0,278.5,320,203,226.5,203,133,203,320,354,133,354,320,0.06644630432128906
278,227,150,186,0,0.33800002932548523,278.0,320,203,227.0,203,134,203,320,353,134,353,320,0.06676435470581055
277,227,151,187,0,0.0,277.5,321,202,227.5,202,134,202,321,353,134,353,321,0.06676626205444336
276,227,151,187,0,0.0,276.5,321,201,227.5,201,134,201,321,352,134,352,321,0.06650829315185547
275,227,151,187,0,0.0,275.5,321,200,227.5,200,134,200,321,351,134,351,321,0.06671500205993652
274,228,151,188,0,0.0,274.5,322,199,228.0,199,134,199,322,350,134,350,322,0.06646180152893066
273,228,150,188,0,0.0,273.0,322,198,228.0,198,134,198,322,348,134,348,322,0.06719684600830078
271,229,151,190,0,0.0,271.5,324,196,229.0,196,134,196,324,347,134,347,324,0.06566166877746582
269,229,151,188,0,0.0,269.5,323,194,229.0,194,135,194,323,345,135,345,323,0.06717681884765625
267,231,151,192,0,0.0,267.5,327,192,231.0,192,135,192,327,343,135,343,327,0.0663301944732666
265,231,153,192,0,0.0,265.5,327,189,231.0,189,135,189,327,342,135,342,327,0.06643939018249512
263,229,152,190,0,0.3320000171661377,263.0,324,187,229.0,187,134,187,324,339,134,339,324,0.06699728965759277
260,229,152,188,0,0.33500000834465027,260.0,323,184,229.0,184,135,184,323,336,135,336,323,0.06685757637023926
257,230,152,190,0,0.3330000042915344,257.0,325,181,230.0,181,135,181,325,333,135,333,325,0.06686663627624512
254,229,152,189,0,0.33500000834465027,254.0,324,178,229.5,178,135,178,324,330,135,330,324,0.06625652313232422
251,229,152,189,0,0.3320000171661377,251.0,324,175,229.5,175,135,175,324,327,135,327,324,0.06631708145141602
247,232,154,192,0,0.3370000123977661,247.0,328,170,232.0,170,136,170,328,324,136,324,328,0.0670781135559082
243,231,155,191,0,0.0,243.5,327,166,231.5,166,136,166,327,321,136,321,327,0.06600022315979004
239,231,155,191,0,0.3370000123977661,239.5,327,162,231.5,162,136,162,327,317,136,317,327,0.06695938110351562
235,231,155,191,0,0.33500000834465027,235.5,327,158,231.5,158,136,158,327,313,136,313,327,0.06576251983642578
231,233,156,194,0,0.0,231.0,330,153,233.0,153,136,153,330,309,136,309,330,0.06730031967163086
226,233,157,195,0,0.3330000042915344,226.5,331,148,233.5,148,136,148,331,305,136,305,331,0.0670626163482666
222,233,156,192,0,0.0,222.0,329,144,233.0,144,137,144,329,300,137,300,329,0.06584811210632324
216,233,158,192,0,0.0,216.0,329,137,233.0,137,137,137,329,295,137,295,329,0.06740355491638184
211,234,158,194,0,0.0,211.0,331,132,234.0,132,137,132,331,290,137,290,331,0.06585168838500977
205,234,159,195,0,0.0,205.5,332,126,234.5,126,137,126,332,285,137,285,332,0.06690263748168945
200,235,160,194,0,0.3230000138282776,200.0,332,120,235.0,120,138,120,332,280,138,280,332,0.06691884994506836
194,238,160,200,0,0.0,194.0,338,114,238.0,114,138,114,338,274,138,274,338,0.06594395637512207
188,241,162,205,0,0.0,188.0,344,107,241.5,107,139,107,344,269,139,269,344,0.06764101982116699
182,239,162,201,0,0.0,182.0,340,101,239.5,101,139,101,340,263,139,263,340,0.06562256813049316
177,239,162,198,0,0.0,177.0,338,96,239.0,96,140,96,338,258,140,258,338,0.06646323204040527
171,239,164,196,0,0.0,171.0,337,89,239.0,89,141,89,337,253,141,253,337,0.06720876693725586
166,239,164,197,0,0.26900002360343933,166.0,338,84,239.5,84,141,84,338,248,141,248,338,0.06615447998046875
161,240,165,198,0,0.27000001072883606,161.5,339,79,240.0,79,141,79,339,244,141,244,339,0.06695723533630371
156,242,166,203,0,0.0,156.0,344,73,242.5,73,141,73,344,239,141,239,344,0.06686210632324219
152,244,166,205,0,0.0,152.0,347,69,244.5,69,142,69,347,235,142,235,347,0.0661153793334961
147,241,166,199,0,0.0,147.0,341,64,241.5,64,142,64,341,230,142,230,341,0.06769466400146484
143,241,166,198,0,0.0,143.0,340,60,241.0,60,142,60,340,226,142,226,340,0.06501221656799316
139,241,168,199,0,0.0,139.0,341,55,241.5,55,142,55,341,223,142,223,341,0.06705665588378906
135,241,168,199,0,0.0,135.0,341,51,241.5,51,142,51,341,219,142,219,341,0.0667576789855957
132,241,168,197,0,0.0,132.0,340,48,241.5,48,143,48,340,216,143,216,340,0.06601667404174805
128,242,169,199,0,0.0,128.5,342,44,242.5,44,143,44,342,213,143,213,342,0.06755900382995605
126,243,169,201,0,0.0,126.5,344,42,243.5,42,143,42,344,211,143,211,344,0.06642651557922363
123,242,170,199,0,0.0,123.0,342,38,242.5,38,143,38,342,208,143,208,342,0.06602978706359863
120,245,170,204,0,0.0,120.0,347,35,245.0,35,143,35,347,205,143,205,347,0.06785821914672852
117,245,171,203,0,0.0,117.5,347,32,245.5,32,144,32,347,203,144,203,347,0.06620907783508301
115,246,171,204,0,0.0,115.5,348,30,246.0,30,144,30,348,201,144,201,348,0.06600141525268555
113,245,171,203,0,0.0,113.5,347,28,245.5,28,144,28,347,199,144,199,347,0.06632518768310547
112,248,170,208,0,0.0,112.0,352,27,248.0,27,144,27,352,197,144,197,352,0.06681346893310547
110,248,171,208,0,0.0,110.5,352,25,248.0,25,144,25,352,196,144,196,352,0.06680536270141602
109,244,171,201,0,0.0,109.5,345,24,244.5,24,144,24,345,195,144,195,345,0.06614112854003906
108,243,172,199,0,0.0,108.0,343,22,243.5,22,144,22,343,194,144,194,343,0.0671684741973877
107,243,172,199,0,0.0,107.0,343,21,243.5,21,144,21,343,193,144,193,343,0.06635403633117676
107,243,172,199,0,0.0,107.0,343,21,243.5,21,144,21,343,193,144,193,343,0.06715202331542969
106,243,171,199,0,0.0,106.5,343,21,243.5,21,144,21,343,192,144,192,343,0.06639647483825684
106,243,171,199,0,0.0,106.5,343,21,243.5,21,144,21,343,192,144,192,343,0.0665285587310791
106,243,171,199,0,0.0,106.5,343,21,243.5,21,144,21,343,192,144,192,343,0.06722879409790039
106,243,171,199,0,0.0,106.5,343,21,243.5,21,144,21,343,192,144,192,343,0.09839820861816406
107,244,172,199,0,0.0,107.0,344,21,244.5,21,145,21,344,193,145,193,344,0.08224725723266602
108,245,171,201,0,0.0,108.5,346,23,245.5,23,145,23,346,194,145,194,346,0.06357431411743164
109,248,171,205,0,0.0,109.5,351,24,248.5,24,146,24,351,195,146,195,351,0.06322884559631348
110,248,171,205,0,0.0,110.5,351,25,248.5,25,146,25,351,196,146,196,351,0.06531500816345215
112,249,172,206,0,0.0,112.0,352,26,249.0,26,146,26,352,198,146,198,352,0.0630807876586914
114,249,172,203,0,0.0,114.0,351,28,249.5,28,148,28,351,200,148,200,351,0.06395792961120605
115,253,172,209,0,0.0,115.0,358,29,253.5,29,149,29,358,201,149,201,358,0.06586694717407227
117,253,172,207,0,0.0,117.0,357,31,253.5,31,150,31,357,203,150,203,357,0.0663454532623291
119,253,172,203,0,0.0,119.0,355,33,253.5,33,152,33,355,205,152,205,355,0.06910133361816406
122,256,172,206,0,0.0,122.0,359,36,256.0,36,153,36,359,208,153,208,359,0.06538748741149902
125,259,172,209,0,0.0,125.0,364,39,259.5,39,155,39,364,211,155,211,364,0.06643939018249512
127,258,173,205,0,0.0,127.5,361,41,258.5,41,156,41,361,214,156,214,361,0.06605720520019531
130,261,173,207,0,0.0,130.5,365,44,261.5,44,158,44,365,217,158,217,365,0.06647849082946777
134,262,172,205,0,0.0,134.0,365,48,262.5,48,160,48,365,220,160,220,365,0.0665128231048584
137,262,173,201,0,0.0,137.5,363,51,262.5,51,162,51,363,224,162,224,363,0.06647014617919922
141,264,172,201,0,0.0,141.0,365,55,264.5,55,164,55,365,227,164,227,365,0.06638598442077637
145,267,172,203,0,0.0,145.0,369,59,267.5,59,166,59,369,231,166,231,369,0.06705093383789062
149,271,172,209,0,0.0,149.0,376,63,271.5,63,167,63,376,235,167,235,376,0.06673622131347656
154,271,173,204,0,0.0,154.5,373,68,271.0,68,169,68,373,241,169,241,373,0.06746888160705566
159,273,173,203,0,0.0,159.5,375,73,273.5,73,172,73,375,246,172,246,375,0.06568074226379395
164,275,174,201,0,0.25600001215934753,164.0,376,77,275.5,77,175,77,376,251,175,251,376,0.06682062149047852
170,278,172,201,0,0.25600001215934753,170.0,379,84,278.5,84,178,84,379,256,178,256,379,0.06725502014160156
175,282,173,204,0,0.25200000405311584,175.5,384,89,282.0,89,180,89,384,262,180,262,384,0.0657198429107666
181,284,173,202,0,0.25300002098083496,181.5,385,95,284.0,95,183,95,385,268,183,268,385,0.0667421817779541
188,291,174,210,0,0.2510000169277191,188.0,396,101,291.0,101,186,101,396,275,186,275,396,0.06691431999206543
194,291,174,204,0,0.25,194.0,393,107,291.0,107,189,107,393,281,189,281,393,0.06566977500915527
201,293,174,203,0,0.0,201.0,395,114,293.5,114,192,114,395,288,192,288,395,0.06755185127258301
208,297,175,205,0,0.2510000169277191,208.5,400,121,297.5,121,195,121,400,296,195,296,400,0.06567955017089844
216,300,175,204,0,0.24800001084804535,216.5,402,129,300.0,129,198,129,402,304,198,304,402,0.06683468818664551
224,303,175,205,0,0.24700000882148743,224.5,406,137,303.5,137,201,137,406,312,201,312,406,0.06655216217041016
233,307,176,205,0,0.24500000476837158,233.0,410,145,307.5,145,205,145,410,321,205,321,410,0.0663156509399414
241,311,176,206,0,0.24500000476837158,241.0,414,153,311.0,153,208,153,414,329,208,329,414,0.06714606285095215
250,314,177,206,0,0.24300001561641693,250.5,417,162,314.0,162,211,162,417,339,211,339,417,0.06673145294189453
260,318,176,206,0,0.23900000751018524,260.0,421,172,318.0,172,215,172,421,348,215,348,421,0.06746649742126465
270,321,178,207,0,0.24000000953674316,270.0,425,181,321.5,181,218,181,425,359,218,359,425,0.0665903091430664
281,326,178,209,0,0.0,281.0,431,192,326.5,192,222,192,431,370,222,370,431,0.06560826301574707
291,330,179,208,0,0.0,291.5,434,202,330.0,202,226,202,434,381,226,381,434,0.06722903251647949
302,334,178,209,0,0.0,302.0,439,213,334.5,213,230,213,439,391,230,391,439,0.06659960746765137
312,337,180,210,0,0.0,312.0,442,222,337.0,222,232,222,442,402,232,402,442,0.06629228591918945
321,341,181,212,0,0.0,321.5,447,231,341.0,231,235,231,447,412,235,412,447,0.06702351570129395
331,344,181,212,0,0.3150000274181366,331.5,450,241,344.0,241,238,241,450,422,238,422,450,0.06591582298278809
341,347,183,212,0,0.3140000104904175,341.5,453,250,347.0,250,241,250,453,433,241,433,453,0.0671529769897461
351,350,183,213,0,0.3140000104904175,351.5,457,260,350.5,260,244,260,457,443,244,443,457,0.06595253944396973
361,353,184,213,0,0.31200000643730164,361.0,460,269,353.5,269,247,269,460,453,247,453,460,0.06676697731018066
370,356,185,214,0,0.31200000643730164,370.5,463,278,356.0,278,249,278,463,463,249,463,463,0.06757330894470215
384,361,186,216,0,0.3110000193119049,384.0,469,291,361.0,291,253,291,469,477,253,477,469,0.10136032104492188
392,363,188,215,0,0.3100000023841858,392.0,471,298,363.5,298,256,298,471,486,256,486,471,0.06420493125915527
401,365,192,215,0,0.3100000023841858,401.0,473,305,365.5,305,258,305,473,497,258,497,473,0.06644296646118164
409,368,194,217,0,0.30900001525878906,409.0,477,312,368.5,312,260,312,477,506,260,506,477,0.06732034683227539
415,370,195,216,0,0.30900001525878906,415.5,478,318,370.0,318,262,318,478,513,262,513,478,0.06581258773803711
422,371,196,216,0,0.30900001525878906,422.0,479,324,371.0,324,263,324,479,520,263,520,479,0.06649279594421387
429,372,198,215,0,0.30900001525878906,429.0,480,330,372.5,330,265,330,480,528,265,528,480,0.06721854209899902
435,373,201,214,0,0.3070000112056732,435.5,480,335,373.0,335,266,335,480,536,266,536,480,0.06602764129638672
442,374,204,212,0,0.30800002813339233,442.0,480,340,374.0,340,268,340,480,544,268,544,480,0.06698179244995117
447,375,205,210,0,0.30800002813339233,447.5,480,345,375.0,345,270,345,480,550,270,550,480,0.06618785858154297
452,375,209,209,0,0.30800002813339233,452.5,480,348,375.5,348,271,348,480,557,271,557,480,0.06728124618530273
458,375,210,207,0,0.30800002813339233,458.0,479,353,375.5,353,272,353,479,563,272,563,479,0.06626105308532715
462,376,211,206,0,0.30800002813339233,462.5,479,357,376.0,357,273,357,479,568,273,568,479,0.06619715690612793
468,377,212,204,0,0.30800002813339233,468.0,479,362,377.0,362,275,362,479,574,275,574,479,0.06677436828613281
472,377,215,204,0,0.30800002813339233,472.5,479,365,377.0,365,275,365,479,580,275,580,479,0.06643939018249512
476,377,215,203,0,0.30800002813339233,476.5,479,369,377.5,369,276,369,479,584,276,584,479,0.06634211540222168
481,378,216,201,0,0.3070000112056732,481.0,479,373,378.5,373,278,373,479,589,278,589,479,0.06750702857971191
484,378,218,201,0,0.3070000112056732,484.0,479,375,378.5,375,278,375,479,593,278,593,479,0.0658266544342041
487,379,220,200,0,0.3070000112056732,487.0,479,377,379.0,377,279,377,479,597,279,597,479,0.06720900535583496
489,379,222,199,0,0.3060000240802765,489.0,479,378,379.5,378,280,378,479,600,280,600,479,0.06642627716064453
491,379,222,199,0,0.3070000112056732,491.0,479,380,379.5,380,280,380,479,602,280,602,479,0.06630396842956543
493,379,223,199,0,0.30800002813339233,493.5,479,382,379.5,382,280,382,479,605,280,605,479,0.06719565391540527
496,380,226,198,0,0.3070000112056732,496.0,479,383,380.0,383,281,383,479,609,281,609,479,0.06743192672729492
498,380,226,198,0,0.3070000112056732,498.0,479,385,380.0,385,281,385,479,611,281,611,479,0.06987547874450684
498,380,228,197,0,0.3060000240802765,498.0,479,384,380.5,384,282,384,479,612,282,612,479,0.062262535095214844
499,381,228,196,0,0.3060000240802765,499.0,479,385,381.0,385,283,385,479,613,283,613,479,0.0668489933013916
499,381,229,196,0,0.3070000112056732,499.5,479,385,381.0,385,283,385,479,614,283,614,479,0.06698083877563477
500,381,227,196,0,0.3050000071525574,500.5,479,387,381.0,387,283,387,479,614,283,614,479,0.06600022315979004
501,381,226,196,0,0.3060000240802765,501.0,479,388,381.0,388,283,388,479,614,283,614,479,0.06719565391540527
501,381,225,196,0,0.3060000240802765,501.5,479,389,381.0,389,283,389,479,614,283,614,479,0.0660865306854248
501,381,226,196,0,0.3060000240802765,501.0,479,388,381.0,388,283,388,479,614,283,614,479,0.06652259826660156
499,380,227,197,0,0.3070000112056732,499.5,479,386,380.5,386,282,386,479,613,282,613,479,0.06723618507385254
498,380,227,197,0,0.3050000071525574,498.5,479,385,380.5,385,282,385,479,612,282,612,479,0.06632685661315918
497,380,227,198,0,0.3060000240802765,497.5,479,384,380.0,384,281,384,479,611,281,611,479,0.06706976890563965
496,379,226,199,0,0.3070000112056732,496.0,479,383,379.5,383,280,383,479,609,280,609,479,0.06602716445922852
495,379,224,199,0,0.3070000112056732,495.0,479,383,379.5,383,280,383,479,607,280,607,479,0.06679534912109375
492,379,223,200,0,0.3070000112056732,492.5,479,381,379.0,381,279,381,479,604,279,604,479,0.06685018539428711
490,379,222,200,0,0.3070000112056732,490.0,479,379,379.0,379,279,379,479,601,279,601,479,0.06640267372131348
488,378,222,202,0,0.3060000240802765,488.0,479,377,378.0,377,277,377,479,599,277,599,479,0.0663442611694336
486,377,220,203,0,0.3060000240802765,486.0,479,376,377.5,376,276,376,479,596,276,596,479,0.0666806697845459
483,377,218,203,0,0.3070000112056732,483.0,479,374,377.5,374,276,374,479,592,276,592,479,0.06621718406677246
480,376,217,205,0,0.3070000112056732,480.5,479,372,376.5,372,274,372,479,589,274,589,479,0.06665468215942383
477,375,216,207,0,0.3070000112056732,477.0,479,369,375.5,369,272,369,479,585,272,585,479,0.06703782081604004
474,374,214,209,0,0.3070000112056732,474.0,479,367,374.5,367,270,367,479,581,270,581,479,0.06621241569519043
470,374,214,210,0,0.3070000112056732,470.0,479,363,374.0,363,269,363,479,577,269,577,479,0.0668799877166748
466,373,212,211,0,0.3070000112056732,466.0,479,360,373.5,360,268,360,479,572,268,572,479,0.06638598442077637
461,372,211,213,0,0.3070000112056732,461.5,479,356,372.5,356,266,356,479,567,266,567,479,0.06689310073852539
457,371,210,215,0,0.3070000112056732,457.0,479,352,371.5,352,264,352,479,562,264,562,479,0.06754136085510254
452,371,209,216,0,0.3060000240802765,452.5,479,348,371.0,348,263,348,479,557,263,557,479,0.06480193138122559
447,370,207,218,0,0.3070000112056732,447.5,479,344,370.0,344,261,344,479,551,261,551,479,0.0673072338104248
443,368,206,220,0,0.30800002813339233,443.0,478,340,368.0,340,258,340,478,546,258,546,478,0.06591105461120605
437,367,203,222,0,0.3070000112056732,437.5,478,336,367.0,336,256,336,478,539,256,539,478,0.06787347793579102
431,364,201,221,0,0.30800002813339233,431.5,475,331,364.5,331,254,331,475,532,254,532,475,0.0658719539642334
426,362,201,222,0,0.30800002813339233,426.5,473,326,362.0,326,251,326,473,527,251,527,473,0.06584572792053223
420,360,199,223,0,0.30800002813339233,420.5,472,321,360.5,321,249,321,472,520,249,520,472,0.06733107566833496
415,357,196,223,0,0.30900001525878906,415.0,469,317,357.5,317,246,317,469,513,246,513,469,0.06613540649414062
409,354,194,223,0,0.3100000023841858,409.0,466,312,354.5,312,243,312,466,506,243,506,466,0.0667266845703125
402,349,192,219,0,0.3110000193119049,402.0,459,306,349.5,306,240,306,459,498,240,498,459,0.06680631637573242
395,346,190,218,0,0.31200000643730164,395.0,455,300,346.0,300,237,300,455,490,237,490,455,0.0664820671081543
388,342,190,217,0,0.31200000643730164,388.0,451,293,342.5,293,234,293,451,483,234,483,451,0.06698417663574219
380,339,188,217,0,0.31200000643730164,380.0,448,286,339.5,286,231,286,448,474,231,474,448,0.06679320335388184
373,335,187,216,0,0.31200000643730164,373.5,443,280,335.0,280,227,280,443,467,227,467,443,0.0664215087890625
365,331,185,216,0,0.3150000274181366,365.5,439,273,331.0,273,223,273,439,458,223,458,439,0.06656861305236816
357,327,186,215,0,0.3140000104904175,357.0,435,264,327.5,264,220,264,435,450,220,450,435,0.06629323959350586
348,323,185,215,0,0.0,348.5,431,256,323.5,256,216,256,431,441,216,441,431,0.06753754615783691
340,319,184,215,0,0.0,340.0,427,248,319.5,248,212,248,427,432,212,432,427,0.06646323204040527
332,315,184,216,0,0.0,332.0,423,240,315.0,240,207,240,423,424,207,424,423,0.0657968521118164
322,311,183,214,0,0.23200000822544098,322.5,418,231,311.0,231,204,231,418,414,204,414,418,0.06702685356140137
314,306,183,214,0,0.0,314.5,413,223,306.0,223,199,223,413,406,199,406,413,0.06611514091491699
306,302,182,213,0,0.0,306.0,409,215,302.5,215,196,215,409,397,196,397,409,0.0676419734954834
298,298,181,213,0,0.23000000417232513,298.5,405,208,298.5,208,192,208,405,389,192,389,405,0.06647968292236328
291,295,181,212,0,0.0,291.5,401,201,295.0,201,189,201,401,382,189,382,401,0.06611132621765137
284,291,181,212,0,0.0,284.5,397,194,291.0,194,185,194,397,375,185,375,397,0.06693911552429199
277,286,182,213,0,0.0,277.0,393,186,286.5,186,180,186,393,368,180,368,393,0.06594300270080566
270,283,180,213,0,0.0,270.0,390,180,283.5,180,177,180,390,360,177,360,390,0.06703305244445801
264,279,180,213,0,0.0,264.0,386,174,279.5,174,173,174,386,354,173,354,386,0.06725502014160156
258,276,179,214,0,0.0,258.5,383,169,276.0,169,169,169,383,348,169,348,383,0.06574726104736328
252,272,179,211,0,0.0,252.5,378,163,272.5,163,167,163,378,342,167,342,378,0.06698417663574219
247,269,180,212,0,0.0,247.0,375,157,269.0,157,163,157,375,337,163,337,375,0.06601309776306152
241,266,178,211,0,0.0,241.0,372,152,266.5,152,161,152,372,330,161,330,372,0.06798648834228516
236,264,179,212,0,0.0,236.5,370,147,264.0,147,158,147,370,326,158,326,370,0.06546235084533691
231,261,179,215,0,0.0,231.5,369,142,261.5,142,154,142,369,321,154,321,369,0.0671992301940918
226,263,179,223,0,0.0,226.5,375,137,263.5,137,152,137,375,316,152,316,375,0.06629133224487305
222,256,179,214,0,0.0,222.5,363,133,256.0,133,149,133,363,312,149,312,363,0.06660676002502441
217,252,179,213,0,0.0,217.5,359,128,252.5,128,146,128,359,307,146,307,359,0.0681300163269043
214,251,178,214,0,0.0,214.0,358,125,251.0,125,144,125,358,303,144,303,358,0.0654301643371582
210,248,178,214,0,0.0,210.0,355,121,248.0,121,141,121,355,299,141,299,355,0.06600236892700195
206,246,179,215,0,0.0,206.5,354,117,246.5,117,139,117,354,296,139,296,354,0.06678509712219238
203,243,178,213,0,0.0,203.0,350,114,243.5,114,137,114,350,292,137,292,350,0.0664358139038086
200,240,178,211,0,0.0,200.0,346,111,240.5,111,135,111,346,289,135,289,346,0.0664060115814209
196,239,179,210,0,0.0,196.5,344,107,239.0,107,134,107,344,286,134,286,344,0.06718754768371582
194,237,178,211,0,0.0,194.0,343,105,237.5,105,132,105,343,283,132,283,343,0.06613659858703613
192,236,178,212,0,0.0,192.0,342,103,236.0,103,130,103,342,281,130,281,342,0.06712794303894043
189,239,179,223,0,0.0,189.5,351,100,239.5,100,128,100,351,279,128,279,351,0.06638693809509277
187,235,179,216,0,0.289000004529953,187.5,343,98,235.0,98,127,98,343,277,127,277,343,0.06706500053405762
185,232,179,215,0,0.2930000126361847,185.5,340,96,232.5,96,125,96,340,275,125,275,340,0.06671023368835449
183,231,179,215,0,0.0,183.5,339,94,231.5,94,124,94,339,273,124,273,339,0.06540632247924805
182,230,178,215,0,0.2900000214576721,182.0,338,93,230.5,93,123,93,338,271,123,271,338,0.06718611717224121
180,229,178,215,0,0.29100000858306885,180.0,337,91,229.5,91,122,91,337,269,122,269,337,0.06658077239990234
179,229,178,216,0,0.29200002551078796,179.0,337,90,229.0,90,121,90,337,268,121,268,337,0.06681108474731445
178,228,178,215,0,0.0,178.0,336,89,228.5,89,121,89,336,267,121,267,336,0.06632208824157715
177,227,178,214,0,0.29100000858306885,177.0,334,88,227.0,88,120,88,334,266,120,266,334,0.06631827354431152
176,226,179,213,0,0.2930000126361847,176.5,333,87,226.5,87,120,87,333,266,120,266,333,0.06696748733520508
176,226,178,214,0,0.29200002551078796,176.0,333,87,226.0,87,119,87,333,265,119,265,333,0.06642770767211914
176,226,178,214,0,0.29100000858306885,176.0,333,87,226.0,87,119,87,333,265,119,265,333,0.06689882278442383
175,226,179,214,0,0.2930000126361847,175.5,333,86,226.0,86,119,86,333,265,119,265,333,0.0674130916595459
175,226,179,214,0,0.2930000126361847,175.5,333,86,226.0,86,119,86,333,265,119,265,333,0.06598138809204102
175,226,179,214,0,0.29100000858306885,175.5,333,86,226.0,86,119,86,333,265,119,265,333,0.06677651405334473
175,225,179,213,0,0.29200002551078796,175.5,332,86,225.5,86,119,86,332,265,119,265,332,0.0668787956237793
175,226,179,214,0,0.29100000858306885,175.5,333,86,226.0,86,119,86,333,265,119,265,333,0.0653829574584961
175,227,179,214,0,0.29100000858306885,175.5,334,86,227.0,86,120,86,334,265,120,265,334,0.06702947616577148
176,228,178,214,0,0.2939999997615814,176.0,335,87,228.0,87,121,87,335,265,121,265,335,0.06691551208496094
176,228,177,215,0,0.2930000126361847,176.5,336,88,228.5,88,121,88,336,265,121,265,336,0.06745433807373047
177,230,178,214,0,0.2970000207424164,177.0,337,88,230.0,88,123,88,337,266,123,266,337,0.06595373153686523
177,230,177,213,0,0.2980000078678131,177.5,337,89,230.5,89,124,89,337,266,124,266,337,0.0659785270690918
177,231,177,213,0,0.2930000126361847,177.5,338,89,231.5,89,125,89,338,266,125,266,338,0.06720995903015137
178,233,176,214,0,0.29600000381469727,178.0,340,90,233.0,90,126,90,340,266,126,266,340,0.06577348709106445
179,235,176,215,0,0.29200002551078796,179.0,343,91,235.5,91,128,91,343,267,128,267,343,0.0664823055267334
179,235,175,212,0,0.2930000126361847,179.5,341,92,235.0,92,129,92,341,267,129,267,341,0.06760287284851074
180,236,175,210,0,0.29100000858306885,180.5,341,93,236.0,93,131,93,341,268,131,268,341,0.06599879264831543
181,236,174,209,0,0.29500001668930054,181.0,341,94,236.5,94,132,94,341,268,132,268,341,0.06631946563720703
181,238,173,207,0,0.0,181.5,342,95,238.5,95,135,95,342,268,135,268,342,0.06741642951965332
182,239,173,207,0,0.0,182.5,343,96,239.5,96,136,96,343,269,136,269,343,0.06558966636657715
183,241,172,206,0,0.3060000240802765,183.0,344,97,241.0,97,138,97,344,269,138,269,344,0.06695246696472168
184,243,172,204,0,0.3020000159740448,184.0,345,98,243.0,98,141,98,345,270,141,270,345,0.06739401817321777
185,245,171,203,0,0.0,185.5,347,100,245.5,100,144,100,347,271,144,271,347,0.0668799877166748
186,248,171,205,0,0.3060000240802765,186.5,351,101,248.5,101,146,101,351,272,146,272,351,0.06534576416015625
187,251,170,204,0,0.0,187.0,353,102,251.0,102,149,102,353,272,149,272,353,0.0661473274230957
188,258,170,212,0,0.26100000739097595,188.0,364,103,258.0,103,152,103,364,273,152,273,364,0.06679773330688477
188,260,169,213,0,0.0,188.5,367,104,260.5,104,154,104,367,273,154,273,367,0.06663894653320312
189,261,169,209,0,0.26200002431869507,189.5,366,105,261.5,105,157,105,366,274,157,274,366,0.06640958786010742
190,267,167,215,0,0.26100000739097595,190.5,375,107,267.5,107,160,107,375,274,160,274,375,0.06658315658569336
192,266,166,208,0,0.2639999985694885,192.0,370,109,266.0,109,162,109,370,275,162,275,370,0.06685972213745117
193,266,165,200,0,0.0,193.5,366,111,266.0,111,166,111,366,276,166,276,366,0.06760668754577637
195,266,164,196,0,0.0,195.0,364,113,266.0,113,168,113,364,277,168,277,364,0.0673072338104248
195,270,163,197,0,0.0,195.5,369,114,270.5,114,172,114,369,277,172,277,369,0.06541132926940918
197,273,162,194,0,0.2710000276565552,197.0,370,116,273.0,116,176,116,370,278,176,278,370,0.06605219841003418
197,275,161,193,0,0.27400001883506775,197.5,372,117,275.5,117,179,117,372,278,179,278,372,0.06648826599121094
198,277,159,190,0,0.2760000228881836,198.5,372,119,277.0,119,182,119,372,278,182,278,372,0.06702017784118652
199,280,159,189,0,0.27800002694129944,199.5,375,120,280.5,120,186,120,375,279,186,279,375,0.06658291816711426
201,282,158,187,0,0.27900001406669617,201.0,376,122,282.5,122,189,122,376,280,189,280,376,0.06740474700927734
202,285,156,185,0,0.27900001406669617,202.0,378,124,285.5,124,193,124,378,280,193,280,378,0.06557154655456543
203,288,155,185,0,0.2840000092983246,203.5,381,126,288.5,126,196,126,381,281,196,281,381,0.06678271293640137
204,291,153,184,0,0.2900000214576721,204.5,383,128,291.0,128,199,128,383,281,199,281,383,0.0680243968963623
205,293,153,181,0,0.28700000047683716,205.5,384,129,293.5,129,203,129,384,282,203,282,384,0.06495404243469238
206,296,152,178,0,0.2900000214576721,206.0,385,130,296.0,130,207,130,385,282,207,282,385,0.06685614585876465
207,300,151,181,0,0.0,207.5,391,132,300.5,132,210,132,391,283,210,283,391,0.0667576789855957
208,302,149,179,0,0.3060000240802765,208.5,392,134,302.5,134,213,134,392,283,213,283,392,0.06635880470275879
210,307,147,178,0,0.0,210.5,396,137,307.0,137,218,137,396,284,218,284,396,0.06706738471984863
211,310,146,178,0,0.0,211.0,399,138,310.0,138,221,138,399,284,221,284,399,0.06594657897949219
211,315,145,181,0,0.0,211.5,406,139,315.5,139,225,139,406,284,225,284,406,0.06699991226196289
212,318,143,182,0,0.0,212.5,409,141,318.0,141,227,141,409,284,227,284,409,0.06676959991455078
213,316,142,173,0,0.0,213.0,403,142,316.5,142,230,142,403,284,230,284,403,0.06645965576171875
214,318,140,171,0,0.0,214.0,404,144,318.5,144,233,144,404,284,233,284,404,0.06668734550476074
215,320,140,169,0,0.0,215.0,405,145,320.5,145,236,145,405,285,236,285,405,0.06639552116394043
215,321,139,167,0,0.0,215.5,405,146,321.5,146,238,146,405,285,238,285,405,0.06663179397583008
216,324,138,166,0,0.0,216.0,407,147,324.0,147,241,147,407,285,241,285,407,0.06632328033447266
216,325,137,164,0,0.0,216.5,407,148,325.0,148,243,148,407,285,243,285,407,0.06800436973571777
217,326,136,163,0,0.0,217.0,408,149,326.5,149,245,149,408,285,245,285,408,0.06576251983642578
217,329,137,162,0,0.0,217.5,410,149,329.0,149,248,149,410,286,248,286,410,0.06659245491027832
218,330,136,161,0,0.0,218.0,411,150,330.5,150,250,150,411,286,250,286,411,0.06630754470825195
218,332,135,160,0,0.0,218.5,412,151,332.0,151,252,151,412,286,252,286,412,0.0674734115600586
219,333,134,159,0,0.0,219.0,413,152,333.5,152,254,152,413,286,254,286,413,0.06627178192138672
219,335,133,158,0,0.3960000276565552,219.5,414,153,335.0,153,256,153,414,286,256,286,414,0.06708431243896484
219,336,133,158,0,0.39500001072883606,219.5,415,153,336.0,153,257,153,415,286,257,286,415,0.06561779975891113
220,336,132,157,0,0.0,220.0,415,154,336.5,154,258,154,415,286,258,286,415,0.0663292407989502
220,338,132,156,0,0.3960000276565552,220.0,416,154,338.0,154,260,154,416,286,260,286,416,0.06690716743469238
220,338,132,155,0,0.40300002694129944,220.0,416,154,338.5,154,261,154,416,286,261,286,416,0.06627917289733887
220,339,130,155,0,0.398000031709671,220.0,417,155,339.5,155,262,155,417,285,262,285,417,0.06670641899108887
220,340,129,153,0,0.4010000228881836,220.5,417,156,340.5,156,264,156,417,285,264,285,417,0.06678390502929688
220,341,129,153,0,0.40300002694129944,220.5,418,156,341.5,156,265,156,418,285,265,285,418,0.06618189811706543
220,343,129,155,0,0.40300002694129944,220.5,421,156,343.5,156,266,156,421,285,266,285,421,0.06691789627075195
220,344,129,154,0,0.4050000309944153,220.5,421,156,344.0,156,267,156,421,285,267,285,421,0.06687521934509277
221,345,128,154,0,0.4050000309944153,221.0,422,157,345.0,157,268,157,422,285,268,285,422,0.06613659858703613
220,345,127,152,0,0.4090000092983246,220.5,421,157,345.0,157,269,157,421,284,269,284,421,0.06695246696472168
221,345,128,152,0,0.40700000524520874,221.0,421,157,345.0,157,269,157,421,285,269,285,421,0.06651997566223145
221,346,126,152,0,0.40700000524520874,221.0,422,158,346.0,158,270,158,422,284,270,284,422,0.06761837005615234
221,346,126,151,0,0.40800002217292786,221.0,422,158,346.5,158,271,158,422,284,271,284,422,0.06518793106079102
221,347,126,152,0,0.41100001335144043,221.0,423,158,347.0,158,271,158,423,284,271,284,423,0.0667269229888916
221,347,126,150,0,0.41200003027915955,221.0,422,158,347.0,158,272,158,422,284,272,284,422,0.06655454635620117
221,347,126,150,0,0.41200003027915955,221.0,422,158,347.0,158,272,158,422,284,272,284,422,0.0665273666381836
221,348,125,150,0,0.41200003027915955,221.5,423,159,348.0,159,273,159,423,284,273,284,423,0.0670011043548584
221,348,125,150,0,0.41100001335144043,221.5,423,159,348.0,159,273,159,423,284,273,284,423,0.06638574600219727
221,348,125,150,0,0.4130000174045563,221.5,423,159,348.0,159,273,159,423,284,273,284,423,0.06820964813232422
221,348,125,149,0,0.4130000174045563,221.5,423,159,348.5,159,274,159,423,284,274,284,423,0.06533646583557129
221,348,125,149,0,0.41200003027915955,221.5,423,159,348.5,159,274,159,423,284,274,284,423,0.06597399711608887
221,348,125,149,0,0.4130000174045563,221.5,423,159,348.5,159,274,159,423,284,274,284,423,0.06698918342590332
221,348,125,149,0,0.41200003027915955,221.5,423,159,348.5,159,274,159,423,284,274,284,423,0.06684660911560059
222,348,124,149,0,0.4130000174045563,222.0,423,160,348.5,160,274,160,423,284,274,284,423,0.06607246398925781
222,348,124,149,0,0.4130000174045563,222.0,423,160,348.5,160,274,160,423,284,274,284,423,0.06640982627868652
222,348,124,149,0,0.4140000343322754,222.0,423,160,348.5,160,274,160,423,284,274,284,423,0.06702828407287598
222,348,125,149,0,0.4150000214576721,222.5,423,160,348.5,160,274,160,423,285,274,285,423,0.06754136085510254
223,349,125,148,0,0.4140000343322754,223.5,423,161,349.0,161,275,161,423,286,275,286,423,0.06581854820251465
223,350,125,151,0,0.4140000343322754,223.5,426,161,350.5,161,275,161,426,286,275,286,426,0.06639289855957031
225,350,126,150,0,0.4140000343322754,225.0,425,162,350.0,162,275,162,425,288,275,288,425,0.06606411933898926
226,358,125,169,0,0.40800002217292786,226.5,443,164,358.5,164,274,164,443,289,274,289,443,0.06667661666870117
227,358,125,168,0,0.41100001335144043,227.5,442,165,358.0,165,274,165,442,290,274,290,442,0.06776213645935059
228,352,125,155,0,0.4130000174045563,228.5,430,166,352.5,166,275,166,430,291,275,291,430,0.06556320190429688
230,350,125,150,0,0.4150000214576721,230.5,425,168,350.0,168,275,168,425,293,275,293,425,0.0666494369506836
233,349,124,149,0,0.41600000858306885,233.0,424,171,349.5,171,275,171,424,295,275,295,424,0.06639409065246582
235,349,124,149,0,0.4130000174045563,235.0,424,173,349.5,173,275,173,424,297,275,297,424,0.06654047966003418
237,349,123,149,0,0.41100001335144043,237.5,424,176,349.5,176,275,176,424,299,275,299,424,0.06671714782714844
240,349,124,149,0,0.4140000343322754,240.0,424,178,349.5,178,275,178,424,302,275,302,424,0.06720185279846191
243,350,124,149,0,0.41200003027915955,243.0,425,181,350.5,181,276,181,425,305,276,305,425,0.06611418724060059
245,350,123,148,0,0.4140000343322754,245.5,424,184,350.0,184,276,184,424,307,276,307,424,0.06670403480529785
249,350,124,148,0,0.4130000174045563,249.0,424,187,350.0,187,276,187,424,311,276,311,424,0.06627202033996582
253,351,124,148,0,0.41200003027915955,253.0,425,191,351.0,191,277,191,425,315,277,315,425,0.0667424201965332
256,351,123,148,0,0.4100000262260437,256.5,425,195,351.0,195,277,195,425,318,277,318,425,0.06680989265441895
260,351,123,148,0,0.41100001335144043,260.5,425,199,351.0,199,277,199,425,322,277,322,425,0.06702828407287598
265,351,122,147,0,0.4100000262260437,265.0,425,204,351.5,204,278,204,425,326,278,326,425,0.06615328788757324
269,351,122,147,0,0.4130000174045563,269.0,425,208,351.5,208,278,208,425,330,278,330,425,0.06857657432556152
274,351,121,147,0,0.41100001335144043,274.5,425,214,351.5,214,278,214,425,335,278,335,425,0.06487798690795898
279,351,120,147,0,0.41200003027915955,279.0,425,219,351.5,219,278,219,425,339,278,339,425,0.06642293930053711
283,352,121,147,0,0.41100001335144043,283.5,426,223,352.5,223,279,223,426,344,279,344,426,0.06698894500732422
288,352,121,147,0,0.4180000126361847,288.5,426,228,352.5,228,279,228,426,349,279,349,426,0.06726455688476562
294,353,123,146,0,0.4240000247955322,294.5,426,233,353.0,233,280,233,426,356,280,356,426,0.06578755378723145
300,353,121,146,0,0.4240000247955322,300.5,426,240,353.0,240,280,240,426,361,280,361,426,0.06642365455627441
306,353,121,146,0,0.42500001192092896,306.5,426,246,353.0,246,280,246,426,367,280,367,426,0.0669560432434082
312,353,120,146,0,0.42900002002716064,312.0,426,252,353.0,252,280,252,426,372,280,372,426,0.06599736213684082
318,353,120,145,0,0.42900002002716064,318.0,426,258,353.5,258,281,258,426,378,281,378,426,0.0670318603515625
325,353,120,145,0,0.4280000329017639,325.0,426,265,353.5,265,281,265,426,385,281,385,426,0.06719803810119629
331,354,121,145,0,0.4280000329017639,331.5,427,271,354.5,271,282,271,427,392,282,392,427,0.06588602066040039
339,354,120,146,0,0.4280000329017639,339.0,427,279,354.0,279,281,279,427,399,281,399,427,0.0668942928314209
345,354,120,145,0,0.4280000329017639,345.0,427,285,354.5,285,282,285,427,405,282,405,427,0.06640124320983887
351,354,119,145,0,0.4280000329017639,351.5,427,292,354.5,292,282,292,427,411,282,411,427,0.0666649341583252
359,355,122,144,0,0.4300000071525574,359.0,427,298,355.0,298,283,298,427,420,283,420,427,0.0669107437133789
365,354,122,144,0,0.4320000112056732,365.0,426,304,354.0,304,282,304,426,426,282,426,426,0.06583881378173828
371,354,121,144,0,0.43300002813339233,371.5,426,311,354.0,311,282,311,426,432,282,432,426,0.06810736656188965
376,355,122,144,0,0.43300002813339233,376.0,427,315,355.0,315,283,315,427,437,283,437,427,0.06640625
382,354,122,143,0,0.43400001525878906,382.0,426,321,354.5,321,283,321,426,443,283,443,426,0.06574606895446777
387,355,124,144,0,0.4350000321865082,387.0,427,325,355.0,325,283,325,427,449,283,449,427,0.06700301170349121
392,354,126,143,0,0.4360000193119049,392.0,426,329,354.5,329,283,329,426,455,283,455,426,0.0663292407989502
397,354,125,141,0,0.4400000274181366,397.5,425,335,354.5,335,284,335,425,460,284,460,425,0.06690001487731934
402,354,126,141,0,0.4410000145435333,402.0,425,339,354.5,339,284,339,425,465,284,465,425,0.06639909744262695
406,355,126,142,0,0.4410000145435333,406.0,426,343,355.0,343,284,343,426,469,284,469,426,0.06667566299438477
410,355,126,142,0,0.44300001859664917,410.0,426,347,355.0,347,284,347,426,473,284,473,426,0.06683707237243652
413,355,127,142,0,0.445000022649765,413.5,426,350,355.0,350,284,350,426,477,284,477,426,0.06689167022705078
419,355,128,143,0,0.44600000977516174,419.0,427,355,355.5,355,284,355,427,483,284,483,427,0.09963274002075195
423,355,128,143,0,0.4480000138282776,423.0,427,359,355.5,359,284,359,427,487,284,487,427,0.06661772727966309
426,355,129,143,0,0.4480000138282776,426.5,427,362,355.5,362,284,362,427,491,284,491,427,0.06727862358093262
429,354,129,143,0,0.4490000307559967,429.5,426,365,354.5,365,283,365,426,494,283,494,426,0.0657651424407959
434,355,130,143,0,0.45100003480911255,434.0,427,369,355.5,369,284,369,427,499,284,499,427,0.10033345222473145
436,355,131,142,0,0.4520000219345093,436.5,426,371,355.0,371,284,371,426,502,284,502,426,0.06639218330383301
438,355,131,142,0,0.45100003480911255,438.5,426,373,355.0,373,284,373,426,504,284,504,426,0.06679677963256836
441,355,131,142,0,0.4520000219345093,441.5,426,376,355.0,376,284,376,426,507,284,507,426,0.06663775444030762
443,355,132,142,0,0.4540000259876251,443.0,426,377,355.0,377,284,377,426,509,284,509,426,0.06694269180297852
445,354,132,143,0,0.453000009059906,445.0,426,379,354.5,379,283,379,426,511,283,511,426,0.06783103942871094
446,355,131,142,0,0.453000009059906,446.5,426,381,355.0,381,284,381,426,512,284,512,426,0.065673828125
448,354,132,143,0,0.453000009059906,448.0,426,382,354.5,382,283,382,426,514,283,514,426,0.06647968292236328
450,355,132,142,0,0.45500001311302185,450.0,426,384,355.0,384,284,384,426,516,284,516,426,0.06717181205749512
451,355,132,142,0,0.4540000259876251,451.0,426,385,355.0,385,284,385,426,517,284,517,426,0.06577110290527344
451,355,133,142,0,0.453000009059906,451.5,426,385,355.0,385,284,385,426,518,284,518,426,0.06736564636230469
452,354,132,143,0,0.45600003004074097,452.0,426,386,354.5,386,283,386,426,518,283,518,426,0.06591105461120605
452,354,133,143,0,0.45500001311302185,452.5,426,386,354.5,386,283,386,426,519,283,519,426,0.06692242622375488
453,354,132,143,0,0.45600003004074097,453.0,426,387,354.5,387,283,387,426,519,283,519,426,0.06618404388427734
453,354,132,142,0,0.45500001311302185,453.0,425,387,354.0,387,283,387,425,519,283,519,425,0.06729435920715332
453,354,132,142,0,0.45500001311302185,453.0,425,387,354.0,387,283,387,425,519,283,519,425,0.06591200828552246
453,354,133,142,0,0.453000009059906,453.5,425,387,354.0,387,283,387,425,520,283,520,425,0.06732654571533203
453,354,133,142,0,0.45600003004074097,453.5,425,387,354.0,387,283,387,425,520,283,520,425,0.06575584411621094
453,354,133,142,0,0.45500001311302185,453.5,425,387,354.0,387,283,387,425,520,283,520,425,0.06687164306640625
453,354,133,142,0,0.4570000171661377,453.5,425,387,354.0,387,283,387,425,520,283,520,425,0.06633830070495605
453,353,133,143,0,0.4570000171661377,453.5,425,387,353.5,387,282,387,425,520,282,520,425,0.06710290908813477
454,353,133,143,0,0.45500001311302185,454.5,425,388,353.5,388,282,388,425,521,282,521,425,0.06659245491027832
454,353,133,143,0,0.4540000259876251,454.5,425,388,353.5,388,282,388,425,521,282,521,425,0.0672764778137207
455,353,134,143,0,0.453000009059906,455.0,425,388,353.5,388,282,388,425,522,282,522,425,0.06562614440917969
455,353,135,144,0,0.4520000219345093,455.5,425,388,353.0,388,281,388,425,523,281,523,425,0.06705808639526367
456,353,135,144,0,0.4540000259876251,456.5,425,389,353.0,389,281,389,425,524,281,524,425,0.06632661819458008
457,352,136,144,0,0.45100003480911255,457.0,424,389,352.0,389,280,389,424,525,280,525,424,0.06698918342590332
457,351,135,145,0,0.453000009059906,457.5,424,390,351.5,390,279,390,424,525,279,525,424,0.06675410270690918
458,351,136,146,0,0.4520000219345093,458.0,424,390,351.0,390,278,390,424,526,278,526,424,0.0672147274017334
459,350,136,147,0,0.4520000219345093,459.0,424,391,350.5,391,277,391,424,527,277,527,424,0.06731295585632324
460,350,136,148,0,0.4480000138282776,460.0,424,392,350.0,392,276,392,424,528,276,528,424,0.06581497192382812
460,349,137,147,0,0.45000001788139343,460.5,423,392,349.5,392,276,392,423,529,276,529,423,0.06599187850952148
462,349,138,148,0,0.44700002670288086,462.0,423,393,349.0,393,275,393,423,531,275,531,423,0.06639814376831055
463,348,138,148,0,0.44600000977516174,463.0,422,394,348.0,394,274,394,422,532,274,532,422,0.06663656234741211
464,347,139,147,0,0.4480000138282776,464.5,421,395,347.5,395,274,395,421,534,274,534,421,0.06680870056152344
465,346,140,147,0,0.445000022649765,465.0,420,395,346.5,395,273,395,420,535,273,535,420,0.06594061851501465
466,345,141,147,0,0.4440000355243683,466.5,419,396,345.5,396,272,396,419,537,272,537,419,0.06983757019042969
468,345,142,148,0,0.44200003147125244,468.0,419,397,345.0,397,271,397,419,539,271,539,419,0.06356978416442871
469,343,141,150,0,0.44200003147125244,469.5,418,399,343.0,399,268,399,418,540,268,540,418,0.06639552116394043
471,342,142,152,0,0.44200003147125244,471.0,418,400,342.0,400,266,400,418,542,266,542,418,0.06776905059814453
472,341,144,154,0,0.4400000274181366,472.0,418,400,341.0,400,264,400,418,544,264,544,418,0.06584000587463379
473,341,144,156,0,0.4360000193119049,473.0,419,401,341.0,401,263,401,419,545,263,545,419,0.06698083877563477
475,340,146,159,0,0.4360000193119049,475.0,420,402,340.5,402,261,402,420,548,261,548,420,0.06704044342041016
477,340,148,163,0,0.43400001525878906,477.0,422,403,340.5,403,259,403,422,551,259,551,422,0.09959602355957031
478,339,149,165,0,0.4310000240802765,478.5,422,404,339.5,404,257,404,422,553,257,553,422,0.06640839576721191
480,337,150,165,0,0.42900002002716064,480.0,420,405,337.5,405,255,405,420,555,255,555,420,0.0681455135345459
482,340,151,176,0,0.4240000247955322,482.5,428,407,340.0,407,252,407,428,558,252,558,428,0.0650489330291748
484,334,152,168,0,0.4270000159740448,484.0,418,408,334.0,408,250,408,418,560,250,560,418,0.06663894653320312
485,332,154,168,0,0.4240000247955322,485.0,416,408,332.0,408,248,408,416,562,248,562,416,0.06697845458984375
486,330,155,170,0,0.4240000247955322,486.5,415,409,330.0,409,245,409,415,564,245,564,415,0.06596803665161133
489,328,157,170,0,0.4240000247955322,489.5,413,411,328.0,411,243,411,413,568,243,568,413,0.06688570976257324
491,324,159,169,0,0.42500001192092896,491.5,409,412,324.5,412,240,412,409,571,240,571,409,0.06617450714111328
493,322,159,168,0,0.4220000207424164,493.5,406,414,322.0,414,238,414,406,573,238,573,406,0.0663301944732666
495,320,160,168,0,0.42000001668930054,495.0,404,415,320.0,415,236,415,404,575,236,575,404,0.06694889068603516
497,317,162,170,0,0.42100003361701965,497.0,402,416,317.0,416,232,416,402,578,232,578,402,0.0687415599822998
498,315,163,171,0,0.42000001668930054,498.5,401,417,315.5,417,230,417,401,580,230,580,401,0.06474971771240234
500,313,164,173,0,0.41600000858306885,500.0,400,418,313.5,418,227,418,400,582,227,582,400,0.06667923927307129
501,317,165,184,0,0.4090000092983246,501.5,409,419,317.0,419,225,419,409,584,225,584,409,0.06737709045410156
503,317,167,190,0,0.40700000524520874,503.5,412,420,317.0,420,222,420,412,587,222,587,412,0.06653308868408203
504,316,169,195,0,0.40700000524520874,504.5,414,420,316.5,420,219,420,414,589,219,589,414,0.0662541389465332
506,312,170,191,0,0.406000018119812,506.0,408,421,312.5,421,217,421,408,591,217,591,408,0.065155029296875
508,307,170,184,0,0.4100000262260437,508.0,399,423,307.0,423,215,423,399,593,215,593,399,0.06724214553833008
509,300,171,177,0,0.41700002551078796,509.5,389,424,300.5,424,212,424,389,595,212,595,389,0.06667804718017578
510,299,172,176,0,0.4190000295639038,510.0,387,424,299.0,424,211,424,387,596,211,596,387,0.06705665588378906
511,300,173,182,0,0.40700000524520874,511.5,391,425,300.0,425,209,425,391,598,209,598,391,0.05458974838256836
512,302,173,190,0,0.40300002694129944,512.5,397,426,302.0,426,207,426,397,599,207,599,397,0.06320977210998535
513,300,175,190,0,0.40300002694129944,513.5,395,426,300.0,426,205,426,395,601,205,601,395,0.06314468383789062
514,296,176,186,0,0.4020000100135803,514.0,389,426,296.0,426,203,426,389,602,203,602,389,0.06428337097167969
515,293,177,185,0,0.4050000309944153,515.5,386,427,293.5,427,201,427,386,604,201,604,386,0.0634317398071289
516,289,178,180,0,0.4050000309944153,516.0,379,427,289.0,427,199,427,379,605,199,605,379,0.0636754035949707
517,287,178,180,0,0.406000018119812,517.0,377,428,287.0,428,197,428,377,606,197,606,377,0.06360197067260742
518,286,180,182,0,0.4050000309944153,518.0,377,428,286.0,428,195,428,377,608,195,608,377,0.06407785415649414
518,285,181,182,0,0.40400001406669617,518.5,376,428,285.0,428,194,428,376,609,194,609,376,0.06540060043334961
519,285,181,184,0,0.4020000100135803,519.5,377,429,285.0,429,193,429,377,610,193,610,377,0.06636452674865723
520,283,182,185,0,0.40400001406669617,520.0,376,429,283.5,429,191,429,376,611,191,611,376,0.06635856628417969
521,284,182,189,0,0.4020000100135803,521.0,379,430,284.5,430,190,430,379,612,190,612,379,0.06701064109802246
521,282,183,189,0,0.4020000100135803,521.5,377,430,282.5,430,188,430,377,613,188,613,377,0.06784415245056152
522,280,183,187,0,0.4020000100135803,522.5,374,431,280.5,431,187,431,374,614,187,614,374,0.06585288047790527
523,278,184,187,0,0.40400001406669617,523.0,372,431,278.5,431,185,431,372,615,185,615,372,0.06539344787597656
523,277,184,187,0,0.4050000309944153,523.0,371,431,277.5,431,184,431,371,615,184,615,371,0.06938648223876953
524,276,184,187,0,0.40400001406669617,524.0,370,432,276.5,432,183,432,370,616,183,616,370,0.06419992446899414
524,276,185,187,0,0.4020000100135803,524.5,370,432,276.5,432,183,432,370,617,183,617,370,0.066741943359375
524,275,185,187,0,0.4000000059604645,524.5,369,432,275.5,432,182,432,369,617,182,617,369,0.06642508506774902
525,276,186,188,0,0.40300002694129944,525.0,370,432,276.0,432,182,432,370,618,182,618,370,0.06631827354431152
525,275,185,188,0,0.4010000228881836,525.5,369,433,275.0,433,181,433,369,618,181,618,369,0.06659865379333496
526,275,186,189,0,0.4000000059604645,526.0,370,433,275.5,433,181,433,370,619,181,619,370,0.06755208969116211
526,275,186,189,0,0.4000000059604645,526.0,370,433,275.5,433,181,433,370,619,181,619,370,0.06573295593261719
526,275,186,190,0,0.4000000059604645,526.0,370,433,275.0,433,180,433,370,619,180,619,370,0.06751298904418945
526,275,186,189,0,0.4010000228881836,526.0,370,433,275.5,433,181,433,370,619,181,619,370,0.06609034538269043
526,274,186,189,0,0.4000000059604645,526.0,369,433,274.5,433,180,433,369,619,180,619,369,0.06624817848205566
525,275,186,188,0,0.40400001406669617,525.0,369,432,275.0,432,181,432,369,618,181,618,369,0.06673502922058105
525,275,186,188,0,0.4000000059604645,525.0,369,432,275.0,432,181,432,369,618,181,618,369,0.06730818748474121
524,274,186,189,0,0.40400001406669617,524.0,369,431,274.5,431,180,431,369,617,180,617,369,0.065887451171875
523,274,187,189,0,0.4010000228881836,523.5,369,430,274.5,430,180,430,369,617,180,617,369,0.06627345085144043
523,275,186,189,0,0.39900001883506775,523.0,370,430,275.5,430,181,430,370,616,181,616,370,0.06734180450439453
522,276,188,190,0,0.4000000059604645,522.0,371,428,276.0,428,181,428,371,616,181,616,371,0.06694984436035156
521,276,186,189,0,0.398000031709671,521.0,371,428,276.5,428,182,428,371,614,182,614,371,0.06621861457824707
520,276,187,189,0,0.39900001883506775,520.5,371,427,276.5,427,182,427,371,614,182,614,371,0.0665745735168457
519,277,186,190,0,0.3960000276565552,519.0,372,426,277.0,426,182,426,372,612,182,612,372,0.06662821769714355
517,279,186,192,0,0.3960000276565552,517.0,375,424,279.0,424,183,424,375,610,183,610,375,0.06697368621826172
515,279,186,192,0,0.39400002360343933,515.0,375,422,279.0,422,183,422,375,608,183,608,375,0.06689810752868652
513,280,186,192,0,0.3930000066757202,513.0,376,420,280.0,420,184,420,376,606,184,606,376,0.06601452827453613
511,280,186,191,0,0.3920000195503235,511.0,376,418,280.5,418,185,418,376,604,185,604,376,0.06648588180541992
508,280,185,191,0,0.39100003242492676,508.5,376,416,280.5,416,185,416,376,601,185,601,376,0.06711506843566895
506,284,186,196,0,0.3880000114440918,506.0,382,413,284.0,413,186,413,382,599,186,599,382,0.06664371490478516
504,283,186,192,0,0.3880000114440918,504.0,379,411,283.0,411,187,411,379,597,187,597,379,0.0672149658203125
502,283,186,190,0,0.38600000739097595,502.0,378,409,283.0,409,188,409,378,595,188,595,378,0.06588482856750488
499,284,186,191,0,0.38600000739097595,499.0,380,406,284.5,406,189,406,380,592,189,592,380,0.0666046142578125
495,286,185,193,0,0.3830000162124634,495.5,383,403,286.5,403,190,403,383,588,190,588,383,0.066925048828125
492,287,185,191,0,0.3800000250339508,492.5,383,400,287.5,400,192,400,383,585,192,585,383,0.06596589088439941
489,293,186,201,0,0.3760000169277191,489.0,394,396,293.5,396,193,396,394,582,193,582,394,0.06690597534179688
485,293,185,198,0,0.37400001287460327,485.5,392,393,293.0,393,194,393,392,578,194,578,392,0.06660318374633789
481,293,185,196,0,0.3750000298023224,481.5,391,389,293.0,389,195,389,391,574,195,574,391,0.06688499450683594
477,295,185,197,0,0.3720000088214874,477.5,394,385,295.5,385,197,385,394,570,197,570,394,0.06729555130004883
473,296,184,197,0,0.3710000216960907,473.0,395,381,296.5,381,198,381,395,565,198,565,395,0.06624937057495117
468,298,185,196,0,0.3680000305175781,468.5,396,376,298.0,376,200,376,396,561,200,561,396,0.06718730926513672
464,300,184,199,0,0.367000013589859,464.0,400,372,300.5,372,201,372,400,556,201,556,400,0.06912732124328613
459,302,183,198,0,0.36500000953674316,459.5,401,368,302.0,368,203,368,401,551,203,551,401,0.0641016960144043
454,304,183,198,0,0.36100003123283386,454.5,403,363,304.0,363,205,363,403,546,205,546,403,0.06715059280395508
448,307,183,201,0,0.3570000231266022,448.5,408,357,307.5,357,207,357,408,540,207,540,408,0.06607842445373535
442,309,181,200,0,0.3540000021457672,442.5,409,352,309.0,352,209,352,409,533,209,533,409,0.06579208374023438
437,310,182,201,0,0.3540000021457672,437.0,411,346,310.5,346,210,346,411,528,210,528,411,0.06679081916809082
430,313,182,201,0,0.35100001096725464,430.0,414,339,313.5,339,213,339,414,521,213,521,414,0.06610918045043945
424,315,181,201,0,0.34700000286102295,424.5,416,334,315.5,334,215,334,416,515,215,515,416,0.06689763069152832
417,319,180,202,0,0.34300002455711365,417.0,420,327,319.0,327,218,327,420,507,218,507,420,0.06638360023498535
409,322,179,204,0,0.33800002932548523,409.5,424,320,322.0,320,220,320,424,499,220,499,424,0.0661318302154541
402,325,179,204,0,0.33500000834465027,402.5,427,313,325.0,313,223,313,427,492,223,492,427,0.06750917434692383
394,328,179,206,0,0.3320000171661377,394.5,431,305,328.0,305,225,305,431,484,225,484,431,0.0650632381439209
386,331,178,206,0,0.3290000259876251,386.0,434,297,331.0,297,228,297,434,475,228,475,434,0.06836533546447754
377,334,178,206,0,0.32500001788139343,377.0,437,288,334.0,288,231,288,437,466,231,466,437,0.06559038162231445
367,337,178,207,0,0.3230000138282776,367.0,441,278,337.5,278,234,278,441,456,234,456,441,0.06624460220336914
358,340,179,209,0,0.320000022649765,358.5,445,269,340.5,269,236,269,445,448,236,448,445,0.0663611888885498
348,344,181,210,0,0.31700000166893005,348.5,449,258,344.0,258,239,258,449,439,239,439,449,0.0667424201965332
338,346,181,211,0,0.3150000274181366,338.5,452,248,346.5,248,241,248,452,429,241,429,452,0.06684994697570801
330,350,182,211,0,0.3150000274181366,330.0,456,239,350.5,239,245,239,456,421,245,421,456,0.06594443321228027
320,353,184,211,0,0.3110000193119049,320.0,459,228,353.5,228,248,228,459,412,248,412,459,0.06738090515136719
311,355,184,212,0,0.0,311.0,461,219,355.0,219,249,219,461,403,249,403,461,0.06673598289489746
302,358,184,213,0,0.0,302.0,465,210,358.5,210,252,210,465,394,252,394,465,0.06599879264831543
294,361,186,212,0,0.0,294.0,467,201,361.0,201,255,201,467,387,255,387,467,0.06644511222839355
284,364,188,214,0,0.0,284.0,471,190,364.0,190,257,190,471,378,257,378,471,0.06667327880859375
275,366,189,215,0,0.0,275.5,474,181,366.5,181,259,181,474,370,259,370,474,0.06713032722473145
267,369,190,216,0,0.0,267.0,477,172,369.0,172,261,172,477,362,261,362,477,0.06641435623168945
259,371,191,217,0,0.0,259.5,480,164,371.5,164,263,164,480,355,263,355,480,0.06619501113891602
251,372,192,215,0,0.0,251.0,480,155,372.5,155,265,155,480,347,265,347,480,0.0666649341583252
243,373,193,213,0,0.0,243.5,480,147,373.5,147,267,147,480,340,267,340,480,0.06796026229858398
235,374,195,211,0,0.0,235.5,480,138,374.5,138,269,138,480,333,269,333,480,0.06521749496459961
228,375,195,209,0,0.0,228.5,480,131,375.5,131,271,131,480,326,271,326,480,0.06692385673522949
221,375,197,207,0,0.0,221.5,479,123,375.5,123,272,123,479,320,272,320,479,0.06614017486572266
215,377,198,206,0,0.21800000965595245,215.0,480,116,377.0,116,274,116,480,314,274,314,480,0.0670924186706543
208,377,198,204,0,0.0,208.0,479,109,377.0,109,275,109,479,307,275,307,479,0.06703066825866699
202,378,200,202,0,0.0,202.0,479,102,378.0,102,277,102,479,302,277,302,479,0.06613445281982422
196,378,200,201,0,0.2160000056028366,196.0,479,96,378.5,96,278,96,479,296,278,296,479,0.06610321998596191
190,379,201,200,0,0.0,190.5,479,90,379.0,90,279,90,479,291,279,291,479,0.0664682388305664
185,379,201,199,0,0.0,185.5,479,85,379.5,85,280,85,479,286,280,286,479,0.06797075271606445
180,380,202,197,0,0.0,180.0,479,79,380.5,79,282,79,479,281,282,281,479,0.06579089164733887
175,381,204,196,0,0.0,175.0,479,73,381.0,73,283,73,479,277,283,277,479,0.06698203086853027
171,381,204,195,0,0.0,171.0,479,69,381.5,69,284,69,479,273,284,273,479,0.06582069396972656
167,382,204,194,0,0.0,167.0,479,65,382.0,65,285,65,479,269,285,269,479,0.06622195243835449
162,382,205,193,0,0.0,162.5,479,60,382.5,60,286,60,479,265,286,265,479,0.06737136840820312
159,383,206,192,0,0.0,159.0,479,56,383.0,56,287,56,479,262,287,262,479,0.06696200370788574
156,383,206,192,0,0.0,156.0,479,53,383.0,53,287,53,479,259,287,259,479,0.06642389297485352
153,383,207,191,0,0.0,153.5,479,50,383.5,50,288,50,479,257,288,257,479,0.0662684440612793
151,384,208,190,0,0.0,151.0,479,47,384.0,47,289,47,479,255,289,255,479,0.06693911552429199
148,384,208,190,0,0.0,148.0,479,44,384.0,44,289,44,479,252,289,252,479,0.06646323204040527
146,384,208,189,0,0.0,146.0,479,42,384.5,42,290,42,479,250,290,250,479,0.06614971160888672
144,384,207,189,0,0.0,144.5,479,41,384.5,41,290,41,479,248,290,248,479,0.06793522834777832
144,384,208,189,0,0.0,144.0,479,40,384.5,40,290,40,479,248,290,248,479,0.06561446189880371
143,384,208,189,0,0.0,143.0,479,39,384.5,39,290,39,479,247,290,247,479,0.0668478012084961
143,384,208,189,0,0.0,143.0,479,39,384.5,39,290,39,479,247,290,247,479,0.06641674041748047
143,384,208,189,0,0.0,143.0,479,39,384.5,39,290,39,479,247,290,247,479,0.06650829315185547
143,384,208,189,0,0.0,143.0,479,39,384.5,39,290,39,479,247,290,247,479,0.0662233829498291
143,384,208,189,0,0.0,143.0,479,39,384.5,39,290,39,479,247,290,247,479,0.06657934188842773
143,384,208,189,0,0.0,143.0,479,39,384.5,39,290,39,479,247,290,247,479,0.0665900707244873
144,384,207,189,0,0.0,144.5,479,41,384.5,41,290,41,479,248,290,248,479,0.06663656234741211
145,384,208,189,0,0.0,145.0,479,41,384.5,41,290,41,479,249,290,249,479,0.06662702560424805
146,384,207,190,0,0.0,146.5,479,43,384.0,43,289,43,479,250,289,250,479,0.06693696975708008
148,383,207,191,0,0.0,148.5,479,45,383.5,45,288,45,479,252,288,252,479,0.06599164009094238
151,383,207,192,0,0.0,151.5,479,48,383.0,48,287,48,479,255,287,255,479,0.06790328025817871
154,382,206,193,0,0.0,154.0,479,51,382.5,51,286,51,479,257,286,257,479,0.06610918045043945
157,382,206,193,0,0.0,157.0,479,54,382.5,54,286,54,479,260,286,260,479,0.06599903106689453
160,381,206,195,0,0.0,160.0,479,57,381.5,57,284,57,479,263,284,263,479,0.0666508674621582
163,381,205,196,0,0.0,163.5,479,61,381.0,61,283,61,479,266,283,266,479,0.06682658195495605
167,380,204,197,0,0.0,167.0,479,65,380.5,65,282,65,479,269,282,269,479,0.0668799877166748
171,379,203,199,0,0.0,171.5,479,70,379.5,70,280,70,479,273,280,273,479,0.06608796119689941
175,378,201,201,0,0.0,175.5,479,75,378.5,75,278,75,479,276,278,276,479,0.06768488883972168
